Y_extendSeq_20nt	class
GTCGTGGTGGGCGCTTTGGTYCCAGAGGAGGCCCAGGAGGA	TRUB1
CATCATGCCCAACAAGAGGTYCTATACCTTTTAATGAATTG	TRUB1
GGGGGGCAGTCAGGGCTGGTYCGAATCCATTTTGTCCGTGG	TRUB1
TTAGCTCCCTGCTCTACGGTYCCATCCCCAAGGCGGCCGTC	TRUB1
GGAAGGCGTTCAGTCAGAGTYCGAGCCTCTGCATCCACCAG	TRUB1
CAAGAACGAAAGTCGGAGGTYCGAAGACGATCAGATACCGT	TRUB1
TGTCTCACCAGTGCCTGGGTYCCAGCCCCAAGACGAGAGTC	TRUB1
TCCTTTGTTTTCTTGCCAGTYCGATCCTTTGGTACAGAAGA	TRUB1
CTTCGTCACTTAATGTTGGTYCCAGTCCTTCAACTGTTCAT	TRUB1
TGGCAAGAAGAAGGTCTGGTYAGACCCCAATGAGACCAATG	TRUB1
ATGTATTTTACGTACAAGGTYCGCTACACTAACAGCTCCAC	TRUB1
GAAGATATGACCTATGCAGTYCGAAAACTGGATAACACTAA	TRUB1
CTTTGTGGCCTGTGGGGGGTYGGACAACATCTGCTCCATCT	TRUB1
TCTGGAATTGTGGAAGTGGTYGGAAGAGTAACCGCCAAGGC	TRUB1
GCTGGTCATTCAGCAGGTGTYCGACAATGGCAGCATCTACA	TRUB1
CTAATGCCAGGGTCGAGGTTYCGATCCCCGTACGGGCCTTT	TRUB1
TGCATGTATGAGGCCTCGGTYCGATCCCCGACACCTCCAAG	TRUB1
TTCACTGCCGCGGCCCGCGTYCGATTCCCGGTCAGGGAATG	TRUB1
GTAAACAGGAGATCCTGGGTYCGAATCCCAGCGGTGCCTCC	TRUB1
ATAATCTGAAGGTCCTGAGTYCGAACCTCAGAGGGGGCAAG	TRUB1
CCCATGCGGGAGACCCGGGTYCAATTCCCGGCCACTGCACG	TRUB1
GTAAACCAGGGGTCGCGAGTYCGATCCTCGCTGGGGCCTCC	TRUB1
CTGTCTAGCGACAGAGTGGTYCAATTCCACCTTTCGGGCGG	TRUB1
GCAATCCTTAGGTCGCTGGTYCGATTCCGGCTCGAAGGACT	TRUB1
GCATGCGAGAGGTAGCGGGAYCGATGCCCGCATCCTCCACT	TRUB1
CAGATCAAGAGGTCCCCGGTYCAAATCCGGGTGCCCCCTTC	TRUB1
TGTGCTCTGCACGCGTGGGTYCGAATCCCACCTTCGTCGAC	TRUB1
TTGGATTCTCAGGGATGGGTYCGATTCTCATAGTCCTAGAA	TRUB1
GTAAACCGAAGATCACGGGTYCGAACCCCGTCCGTGCCTGA	TRUB1
TGAAACCAGCTTTGGGGGGTYCGATTCCTTCCTTTTTTGTC	TRUB1
TGGGGTCTCCCCGCGCAGGTYCGAACCCTGCTCGCTGCGGA	TRUB1
TTAATCTGAGGGTCCAGGGTYCAAGTCCCTGTTCGGGCGTC	TRUB1
CGGATCAGAAGATTGAGGGTYCGAATCCCTTCGTGGTTAAG	TRUB1
CAGATCAGAAGGCTGCGTGTYCGAATCACGTCGGGGTCAAA	TRUB1
TTAACCGAAAGGTTGGTGGTYCGATCCCACCCAGGGACGGA	TRUB1
GGCATTCAAAGGTTCCGGGTYCGAGTCCCGGCGGAGTCGTA	TRUB1
TTAATCTCAGGGTCGTGGGTYCGAGCCCCACGTTGGGCGCT	TRUB1
AGCGAAAAGCTGTTGTAGTTYGCCCAAAAGATGAAGACTAT	PUS3
GCCATTCCTTGGGGCATTTCYGCCACTGCAGCCCTCAGGCC	PUS3
CTAAAACCCCTAAGTGAGGTYGCCCAGGGGGTTGTCCCCAG	PUS3
GGAATTCCCAAACTCGATGAYGCCAATGATGCAGGTATATA	PUS3
CAGACTGTCAAGAACAAGTAYGCCACATCGAAGCATGCTAA	PUS3
ATCTCCTCAGATGGCCAGTTYGCCCTCTCAGGCTCCTGGGA	PUS3
CAGAGCAGGCTGGAGGGATTYGCCACACAGCCCCACCCTTG	PUS3
CTTTTTACCCTCTAGATGGTYGCCACCCTGGGGACCACAAC	PUS3
GGAGGTAACAAGAAATACCGYGCCCTGAGGTTGGACGTGGG	PUS3
AGGAGGCATGCCAGGAGGAAYGCCTGGGGGATTTCCTGGTG	PUS3
TCTTCTGGAGCTCAACTTCTYGCCAACCACAGGGACCAAGC	PUS3
ATGTTTCACTTTCTAGCTGGYGCCGACAAGAAAGCCGAGGC	PUS3
GGGTTGTTTTTGTTTTTTCTYGCCAGGTAGATAAAACTGAC	PUS3
TGGTTGGGCCTGGTTGACTTYGCCAGTCAGCTCCTACAGTG	PUS3
CACGGGAAAGTAGAGATAATYGCCAATGATCAGGGAAACCG	PUS3
GCTCATGTGGAGTATAGCACYGCCGCCCGCCACTACGCCCA	PUS3
GCCATTCTGGGGGTGTCCCTYGCCGTCTGCAAAGCTGGTGC	PUS3
ACATGGCCCGCAGTGGCTTTYGCCCCAGAAAGGGGAAAGGA	PUS3
CTTTGCTGATTCCGATATAGYGCCCCCAGCCAGTACCTGGG	PUS3
GGTGAAGTCGGTGCCACTTCYGCCCTGGCCCCCAAGATCGG	PUS3
CTGAGCGGTTGTGGCCGCGTYGCCGACCTCCAGCAGCAGTC	PUS3
CTTGGGGGTGTTCCTCTATTYGCCTGCCACCTCTCTTGTCT	PUS3
CCTCATCTGGTGACTCATGAYGCCCGCACCATCCGCTACCC	PUS3
TCTAGTTGCTGGTTCTTACAYGCCACCATCCACAGTCCTTC	PUS3
GACCAGCAGCGTCTGATATTYGCCGGCAAACAGCTGGAGGA	PUS3
AGACAACAAGCAGCCTATTAYGCCCAGACAAGTCCCCAGGG	PUS3
CCCACCGTGTTCTTCGACATYGCCGTCGACGGCGAGCCCTT	PUS3
TCGGCGCCCACCTCGGCCGCYGCCTCCCCGTTGTCGGCGGC	PUS3
AGTCCTATGGCATGAATGTTYGCCAACCAACCCCAGGAAAA	PUS3
CTGAGGAACAGACTTAAGTAYGCCCTGACAGGAGATGAAGT	PUS3
ACCTTGAACAAGTTCAATTTYGCCAGGAACAGTACCCTCAA	PUS3
ACCTCCTGCAGGGAGCCTTCYGCCACCAGCCCCTCCCCAGA	PUS3
TGGACCCCAGGCCCGGGCCCYGCCCACCTGAGCTGGGCCTG	PUS3
ACTGCTTCCATGTTGGCATCYGCCCCTCCTCAAGAGCAAAA	PUS3
GCAATGTATCCTGATTACTTYGCCAAGAGAGAACAGTGGAA	PUS3
CTTTCATGCCTCTGATCATGYGCCCAAGCCAGGAGTGCCAA	PUS3
GTCGCCTCCTACCTGCTGGCYGCCCTAGGGGGCAACTCCTC	PUS3
TCTTAGTTCAACTTTAAATTYGCCCACAGAACCCTCTAAAT	PUS3
GCTGGATTGTCTCGTTTTCCYGCCAAATAAACAGGATCAGC	PUS3
AATCTGTTCGCTTCATTCATYGCCCCCACAATCCTAGGTCT	PUS3
CTTCTCAGGGTTGGAAATTGYGCCAAACGGGATCACATTGC	PUS3
TCCTATTGCTCGGGCTGTAGYGCCCTCGAAACGTCAGCGTG	PUS3
GATTACGATGCTTTGGATGTYGCCAACAAAGTAAGTTTCCT	PUS3
TGTCTCTCTTGGATGATGTTYGCCGTCAGCATTCACCAAAT	PUS3
ACCCAGATTAGTGTGAGCCTYGCCAAAGATGAGCCTGACAC	PUS3
GGCCCAGCAGGGAGCTCGTAYGCCGCTCGTGCCTGAAGCAG	PUS3
AACCTTCTGCTGTGTATGTAYGCCAAGGAGACCGTGGGCTT	PUS3
TGCGCTCCTCTCCGCAGATAYGCCAGCCTCTACTTCTGCTG	PUS3
TTTCCACTTAACGCAATTTAYGCCAAACCTGCAAACAAACA	PUS3
GATCGCCTCTTTGACATTTTYGCCAAAATACCACTAGTGGA	PUS3
TTTCCGCGTACAGAAGTGCTYGCCCGGGGAGTCCCGCCTGA	PUS3
TTCCTGAGGAACATGCGCTTYGCCAAGAAGCACAACAAAAA	PUS3
ATCTTCATTGATGAGTTGGAYGCCATCGGCACCAAGCGGTA	PUS3
AAAAAAATTACTTATTTTCTYGCCCCATACATACCTTGAGG	PUS3
GGCTGTGTAGACACCAGCGTYGCCCCCCGCCAACCTACTCA	PUS3
CAGGACTAGGGACAGGGCTGYGCCGGCCTGGGCCAGGGCCC	PUS3
GATGGCGGCGCCGGGGGCGCYGCCTCCTCGGCCGCCGCCTC	PUS3
GGCCGCTACCTGACGGTGGCYGCCATCTTCCGGGGCCGCAT	PUS3
TCTCGGTGCCGAAGATTGCCYGCCAGAGGACTGACCACAGC	PUS3
CAGGAGAAGCCAAAAATGTTYGCCAAGGGAACTGAGATCAC	PUS3
GTTAATTGAGAATAGAAATTYGCCCCTGGCAAATGCACACA	PUS3
TCGTCCATCCCATCTTCCTTYGCCCCCAGGAAAGGACGCAT	PUS3
CAGTGAAGATGTTTACTCATYGCCCCCACCTCTGGTCCACA	PUS3
GTTTGGTAGCGTATCCAGTAYGCCAAGACCGACTCAGATAT	PUS3
AAAACAGCCTTTACCATCCCYGCCATTAAGGGTGTGGGCCA	PUS3
AGGAGTGCGAGCACTGCGACYGCCTGCAGGGCTTCCAGCTC	PUS3
TGATTTTGAGCGGCACTTCCYGCCAGCCAGTCGAAATCGGA	PUS3
GCACAACCTCAAGGCTAAGAYGCCCAAGAAGGGGAAGCCCC	PUS3
ACCTGGATATAAATTAATTGYGCCTGCCACCACCATCCAAC	PUS3
GATCACAGGATAGGTATTTTYGCCAAGAGAGCCATCCAGAC	PUS3
CTCTGAGCAGAAGATGGCTGYGCCACCCACGTATGCCGATC	PUS3
GAAGTTGAGTTGATGAAAGTYGCCAGAGCACATCCCAAAGC	PUS3
GTATTTGAATGGGAAGCTTTYGCCCGGGGAACCAAAGCTCT	PUS3
GCCAAAAGGGTCATTACCTCYGCCCCCTCTGCTGATGCCCC	PUS3
TGCAAAGAGATCTGGAAATTYGCCATGAAGGAGATGGGAAC	PUS3
GACCCCTTGGTGGGAAGTATYGCCACTCAGTATATGACCAA	PUS3
CCAGATCACTGTTAATGATTYGCCTGTGGGACGCTCCGTGG	PUS3
TTTTCCTTCCCAGCTTCTGTYGCCACCGGGCCAGACTCCCC	PUS3
GCGTCTTCCTCTTCTCCTTAYGCCAGGATGCCGAGCTACAG	PUS3
CGATTTAGACCTGCGGGTGCYGCCCCACGTCCCCCACCAAA	PUS3
TCTAGAGCTTTGGCTGAAATYGCCAAAGCCGAACTGGATGA	PUS3
GTTTTCTTCATTTTCATAGTYGCCAACCATCATAGCTGACA	PUS3
AGAGCTAAATCTTGAGATTTYGCCCCCGGTAAGCATAAAGC	PUS3
GATAGCAACTGGATCGTGGGYGCCACGCTGGAGAAGAAGCT	PUS3
TCCATCTTGTTTCATTTGCTYGCCCCGCCCCCGAGACGGAG	PUS3
GCTCTCAAGAGCATCAACAAYGCCGAAAAGAGAGGCAAACG	PUS3
TAGGTTGTTCAACAGTGTTGYGCCAGCCTACAGGAGGAAAG	PUS3
CAAAATCTGCATGTGGCGTGYGCCCAGGCAGACTTCGAGGG	PUS3
CAACAAAACTGTGTCTTATCYGCCAGGAAAGACCAGCCTCA	PUS3
CTGGATATAAATACTGCCTAYGCCAGACTCAGAGGAATCGA	PUS3
GCCACCCATGCTGGTGCCATYGCCCCATGTGAAGTCACTGT	PUS3
ACCACCATGTATCTGGGAATYGCCGACAGGATGCAGAAGGA	PUS3
TGAGGCGCCGCCATTTTTGCYGCCCGGACGCGGAGCGAGAG	PUS3
CCTATTCGCTGCACTAACTGYGCCCGATGCGTGCCCAAGGA	PUS3
CGAGCTGTTGTCTTCCTGCCYGCCCTGTGTCGTAAAATGGG	PUS3
GTTCTTGTATGTGGAAGGCTYGCCAGAGGGGATTCCCTTCC	PUS3
GGATGAGGTTTTGAAGATTAYGCCAGTGCAGAAGCAGACCC	PUS3
GAGGCTACGTGAAGGAAGTTYGCCTGGAGACATTTCTACTG	PUS3
TTTGTGTACCCTCTTGATTTYGCCCGTACCCGTCTAGCAGC	PUS3
ACTGACTTGATTTTTCATTCYGCCACTCCATCTTCAAACCC	PUS3
GCCCCCGCTAACCGGCTTTTYGCCCAAATGGGCCATTATCG	PUS3
TCTTACAGCAAACTGTAGTTYGCCTCCAAGACACCATTGTC	PUS3
ACAACACCCATTTTTCCTTTYGCCGACCCCAAGAGTTTTGG	PUS3
TTCTATATTGGTCATTGCCTYGCCAAACAGGAGCTCCAGCA	PUS3
TTGTCAAGGGGCTCAGGCTGYGCCGGCCAAAGGCCAAGGCC	PUS3
AAAATCAGGATTTTAGTGCTYGCCACCACCAGATGAGAAGT	PUS3
GCCAGGAAGTACAAGCAGGCYGCCAAGTGCCTCCTGCTGGC	PUS3
GGTGCAGACGGAGGCCCCCGYGCCTGTCAGCGTGCAGCCCC	PUS3
CTTGATCGACTTGCCTACATYGCCCACCCCAAGCTTGGGAA	PUS3
GTGCCCATGTACAAGGGGCAYGCCCTCCCCCATGCCATCCT	PUS3
TTGGCCACAGAGGACTCACTYGCCCACACCGAGGGCGACCC	PUS3
GGGGCTGTGGCCGTCTCTGCYGCCCCAGGCTCTGCAGCCCC	PUS3
CGAGGCTCTGAGCGAAGCTCYGCCCGGCGACAACGTCGGCT	PUS3
CGGCTGTCCTCCCGTTCCGCYGCCCGCCCTGCCACCATGAC	PUS3
CGCTAAGAGAGTCACCATCAYGCCCAAAGACATCCAGTTGG	PUS3
AAAAGGAAAAATTTTATCACYGCCATCACAGCAGGTTTCCT	PUS3
TTATTTGCTGCTGTTTAAGTYGCCAACCTCCCCTCCCAATA	PUS3
AAGCGGATGGTGGTTCCTGCYGCCCTCAAGGTCGTGCGTCT	PUS3
GGCCAGGAAGTGGTGTTTGTYGCCGAGCCAGACAACAAGAA	PUS3
TACTATGTGACTATCATTGAYGCCCCAGGACACAGAGACTT	PUS3
GGCTGCCGTTCCAGCTGGACYGCCGCCATGGAACTCAGCGC	PUS3
TTTGGTGTTGGCTTTTATTCYGCCTACTTGGTGGCAGAGAA	PUS3
AACGTACCTGTCAAGCTCTTYGCCCGCTCCACAGCTGTCAC	PUS3
CCGCTGATTTTCCCAGCTGCYGCCCAATAAACCTGTCTGCC	PUS3
ACTGGCAATAAAGTTTTTGGYGCCCTGAAGGGAGCTGTGGA	PUS3
CAGCAGTACATGCAGAGCAAYGCCGAGGTTGTGAGTTCGAG	PUS3
CGGACCAGAGCGAAAGCATTYGCCAAGAATGTTTTCATTAA	PUS3
GAGGGCCTGCTATGGTGTGCYGCGGTTCATCATGGAGAGTG	PUS3
ACACTGTGAGTTTGCCTACCYGCGGGACCTTCTCATCAGGT	PUS3
GGACCTCGGACCTTGGAGCCYGCGGGGTGCCTCGGCCCCTC	PUS3
GAGGAGAAAGCCAAGGAGATYGCGAAGATGGCAGAGATGCT	PUS3
GTGTAACACAGATTCTCCTCYGCGCTATGTGGACATTGCCA	PUS3
GCCCTGCTCACGTACATGATYGCGCACATCACGGGCCTGAA	PUS3
CCATCTTTCTTTTCAGTCCTYGCGCACCGGGGAACAAGGTC	PUS3
CCACCCCAAGGGGCGGCTGCYGCGAGAAGAGCTCGCTGCGG	PUS3
CTTGTTTGCTTCGCCAGGGCYACGGGGACCACAAGCCCAAG	PUS3
GAGGCTCGCAGCCGTGGCCAYGCGTCCCCACTGGCGGCCAA	PUS3
TGTCCTTGTCGCCCAAACTCYGCGCGGAGAAAGAGGCGGCC	PUS3
GCAAGGCCGGAGTGAGTGCCYGCGGCCCCTCACAGGGCTGA	PUS3
TTCTCCGTGCAGGGATCCTGYACGACACGTACCCACTCTCG	PUS3
TCGCTCCTCCACCAGTTTATYGCGACGTAGCATCCAGGCCT	PUS3
GAGACTGCTGAGCCCGTCCGYCCGCCGCCACCACCCACTCC	PUS3
CCCATATTGTAACTTACTACYCCGGAAAAAAAGAACCATTT	PUS3
TACGCAGTTTTCTTTGGCTTYACGAAGCCGATTAAAAGACC	PUS3
GTCGTGTGTTCTGGATTCATYCCGGCACCACCATGTAAGTG	PUS3
CTCCCGTTCCCTCTTCCGCTYGCGCTGCCGCAGGTGGGCCC	PUS3
GGACAAGGCAGTGGAGTCCTYACGGGCCATCTCACACGAGC	PUS3
AGACGAGTTAAGTCCTGGTCYGCGTGGAGGTCGACGACTCC	PUS3
TTCCGGATTTCCTTGGGTCTYCCGGTAGGAGCTGTAATCAA	PUS3
TATTTTCTTTCAGTTAATGCYGCGGACAACAAACAAAGGGA	PUS3
CCTCGCCCTCCTGCCCTGGGYGCGGCCCCCCGGGTCCCGGC	PUS3
TTCTGTGCTTAGAACATTTTYACGGACCTAAGCGCTGGAGA	PUS3
TATGTTCTGATCTGGAATCCYGCGGCGGCGGCGGCGGCGGC	PUS3
TGGGCCCTGGGCTTCTACCCYGCGGAGATCACACTGACCTG	PUS3
GTTGGCAAGAACAAGAGCCTYACGAAAGGCGGCAAAAAGGG	PUS3
CATGATATGAGACAGACACTYGCGGTGGGTGTCATCAAAGC	PUS3
TTGCTCGATGTCTTGGTAAAYACGGCATCATCTGCATGGAG	PUS3
CAGATTTCCATAAAAACCCTYACGGGGAAGACCATCACCCT	PUS3
CAAGCTCTCCATTGTCCCCGYGCGCAGAGGCTACTGGGGGA	PUS3
GAGACATCATCTTCAAATTCYACGAGTCCAAGTACGCCTCA	PUS3
GGTGTTTGAGAAGCCCCCACYGCGGGTGAAGAACTTCGACA	PUS3
TTACTTCAAGAAGCAGCAGCYGCGGAAGCCCAGACACCAGG	PUS3
ACAAAGTGGAGTACACGCCTYACGAGGAGGGTGCGTGCTGG	PUS3
GTGACCTCCTGTCCCCATGGYACGTCCCACCCTGTCCCCAG	PUS3
TGGCTATGAGAGAGATTTTTYGCGATACTTACAGAGCTTAC	PUS3
GCATGGATCCCTATGATGGCYACGGTGAGGACAACGCCTCC	PUS3
TGGAAAACGATCTTTTGGATYACGATGAAGAGGAAGAGCCC	PUS3
GAGTCGCCCCGACCTTTCTCYGCGCAGTACGGCCGCCGGGA	PUS3
CCTTTTCCTTGCTCGGGTCCYGCGTCCGCGCCTGCCCCGCC	PUS3
GGTTCGGTACCACACGAAGGYGCGCGCCGGCCGCGGCTTCA	PUS3
GCGGTCCCTGAAGCCATCCCYACGCCCCGAGCTGCGGCCTC	PUS3
AGTCAGCCAAGATGTTTAACYACGCGGGATGGAAGAACACC	PUS3
CTCACTTTCCCTCCATTTGTYACGTGAGAGAATGCGTCTGC	PUS3
CCAGGAGGTGGTGGTGTGCAYGCGGAGGGACACAGCGCTGG	PUS3
GCGGGCCCGTGTTCACGGATYCCGGCATCCACATCATCCTC	PUS3
TCTGCAAAAAGAATTGAACCYGCGGAAGAGCTGAACAGCAA	PUS3
TGAACGAGTTTGGGGAGTCCYACGAGGAGAAGGCCACGCGG	PUS3
CCTTCCTGGGTATGGAATCTYGCGGCATCCACGAGACCACG	PUS3
GTTCCTGTGCCATGAGTTCCYGCGAGGGAACCCACGGGTGA	PUS3
GATGCTGGCTCAGGAAGTTCYGCGCATGCGTGGCACCATTT	PUS3
CTACCTCTATATCCGAATGCYGCGATCCCCAACCCTCTATG	PUS3
GAGTGGGGTCACCACGTGCCYGCGCTTCCCGGGCCAGCTGA	PUS3
ACTTTGCCAATGTGCTCACCYCCGACAACCACTCAGACTAC	PUS3
CCAAGACCGTGGCCTATTTCYACGACCCCGACGTGGGCAAC	PUS3
AAGAGGAGGAGGAGGAGGATYCCGAGGTGCAGGGGGAGCAG	PUS3
ATCCTAGAATCACTGAAGTCYGCGGGACAAGAGAACCTGGA	PUS3
GGGGCTGCACTGGACGTGTTYACGGAAGTAAGTGCCTGGCA	PUS3
GCGGTAAGGCTGGGAAGGACYCCGGAAAGGCCAAGACAAAG	PUS3
TGGGCAGACTAAGCCGATTTYCCGGAAAAAGGCTAAAACTA	PUS3
GGGGACATGCACGTGTGAGAYGCGGCAGCGGGCGGCGCGGA	PUS3
TGCTGCTGACTCTGTGCAGCYGCGCACCTGTGTCCCCCACC	PUS3
AGTGAAGGGTTTTCAATTCAYACGCGGGATAGCCCCAAATG	PUS3
TGCCTGCGGGCTTTCTGGTCYCCGGATGGAGGCGTGGGTTC	PUS3
CGATGAAGAACGCAGCTAGCYGCGAGAATTAATGTGAATTG	PUS3
GACCCCCTTCGCGGGGGGGAYGCGTGCATTTATCAGATCAA	PUS3
GGTATGATTCTCGCTTAGGGYGCGAGAGGTCCCGGGTTCAA	PUS3
ATGTACCTGTGATGATCACTYGGAATCCACACTGGTACCGC	PUS1
AAAGACTATTTTACTAAATTYGGAGAGGTCGTTGACTGTAC	PUS1
CAGCGCCGCGGAGCCTCGGTYGGCCTCGGATAGCCGGTCCC	PUS1
GCCGCCGCGGTTGATGTGGTYGGGCCGGGGCTGAGGAGGCC	PUS1
ATGCAGACGGACGAAGAGATYGGGAAGGTGGCGGCGGCGGT	PUS1
GATGGCTTTTGGTTGTATCTYGGAAGGACCAGAGCCCAGTC	PUS1
AACCATTTTAACTGTATTTTYTGCAGCCCGTACCTTCTTGG	PUS1
TTGGCTCATGAAATAGGTTTYGGAAGTAAAGTTACAACACA	PUS1
TTGCTGCAGCTTAAAATGATYGGAATCAAGAAGGTACAGGG	PUS1
ATTTTCCATTCTAAAAGTTTYGGAGAGGGAAATCCAGGCTA	PUS1
TGGCGGCGGTGGCGGACACTYGGGGTCTGGACGCAACGGCG	PUS1
CAAGAAGTATGATGCGTTTTYGGCCTCAGAGTCTCTGATCA	PUS1
AATAGCTTGCCTTTCTCACTYGGCAAGGAAGATGGAAGTGG	PUS1
CCTAATTCTTCTGCTCTGTTYGGGAAGACGTGGAGGAAAAG	PUS1
CCAGACCATTAATTTGATTTYGGATGAAAGCCATGAACGAG	PUS1
TTGGATGAGGATACAGGATTYGGTCTCTTTGACTAATCACC	PUS1
CGAGGGAGAGAGTTTTCCTTYGGTAAGTAAGCGTTTTATTT	PUS1
CAAAACAAATGTTAAATTCTYGGCTATTACGACAGACTGCC	PUS1
TTGAGATGTATGAAGGCTTTYGGTCTCCCTGGGAGTGGGTG	PUS1
GGATTCCATGTTCATGAGTTYGGAGATAATACAGCAGGTGG	PUS1
GTGTAAATGTTGAGCCTTTTYGGCCTGGCTTGTTTGCAAAG	PUS1
AAATTTACATCATTTCTTTTYGGGAGAGACTTGTTTTGGAT	PUS1
AGCAGCTGGACTGGGGCCTTYGGCACAGCAGCCGGTGTCTC	PUS1
CTCTTGTTTGTCATCTTATTYTGGGTGCTGGGGTGGCTGCC	PUS1
AGACCAGACAACTTTGTATTYGGTGAGTTATACAGATGATA	PUS1
CATCTAAACTTAGATGGAGTYGGTCAAATGAGGGAACATCT	PUS1
TTTGAGCGCTCGCCGTCTTTYGGCGGCAGCGGCGACGCGAG	PUS1
CCGGCTCATAAAGGTTCATTYGGACAAAGCACAGCAGAACA	PUS1
GATAGCCAGGGCTGTTGTTTYGGGGCCCTTCAAGGCAAAAG	PUS1
GTTGGGAGTTGCTTGGAGGTYGGCGGCGCGGGGCTGAAGGC	PUS1
TATGCCAAAGATGTAAAATTYGGTGCAGATGCCCGAGCCTT	PUS1
TTCTGTTTTTGTTACTTAGTYGGAGAAGGAACGAGAGAAGG	PUS1
TCTCCGTGCATTTGTGCCTTYGGAACAGAGCCAAACGCCGT	PUS1
TCTGCATTTTTAAAACAGTTYGGCCATAATCCTAGATGCAC	PUS1
TGCCCTTCACCTAGCTCCCTYGGCCAGGAGCGAGCGAAGCC	PUS1
GCACCACCCCACTTCCATTTYGGCCAAACCAACCGCACCTC	PUS1
AGAAGGCAGAGGCTTCCTTTYGGACCGCCGAGGAGGTAATC	PUS1
CTCTTACAGAGAGGCGGATTYGGTCGTGGACGTGGTCAGCC	PUS1
AGACCAGACAATTTCGTGTTYGGTGAGTGCCTGGTGTGGCT	PUS1
TCACCTGGCTGTCAACTTCTYGGTGTCATTGCTCAAGAAAA	PUS1
AGTAGCCAATGTTTCTCTTTYGGCCCTATACAAAGGCAAGA	PUS1
TCAATCCTCTCAGTTGTACTYGGAGACCTGCCTCCCAGCCC	PUS1
AAGGTCAGGGTCAGTGGATTYGGTCGTATTGGGCGCCTGGT	PUS1
GAATACTAATCCATTCCTTTYGGCCCTGCAGCATGTCGTGC	PUS1
TCGATGCCGGAAAAACACCTYGGCCCGCCGGAAGGGCAGGC	PUS1
AAGCAGAATTCACCAAGCGTYGGATTGTTCACCCACTAATA	PUS1
CATGCTGTCTCTAGACTTTTYGGACGATGTGCGGCGGATGA	PUS1
GCCTGTACTTGTCCACTGGAYTGAAGGCAGAGAAGGAAGGG	PUS1
TTTGATCTTTTGATTCCTCTYGGGCTGAAGCAGACCAAGTT	PUS1
TTGCCTTTCTGACATTTCCTYGGGAATCTGCAAGAACCTCC	PUS1
GCCGGATGGAACTTTGGGATYGGTAATAAAACTGCAGTGCC	PUS1
ACCTGTCTGGTGAGTTTGTTYGGACAACCTAACTCAGCTTT	PUS1
TAAGGAAATGCTGAAGCTTTYGGTAAGTGTTTGCTGGATTC	PUS1
GCAAGTGAGGCCTATCTGGTYGGCCTTTTTGAAGACACCAA	PUS1
TCTTCTTCAATATGTGAATTYGGGCTCACAGAATCAAAGCC	PUS1
ACCCCTGGAAAGACACCAATYGGCACACCAGCCATGAACAT	PUS1
TGCCCTCTGCTGTCACCACTYGGTCAGAAACTTCCAAACGC	PUS1
AGCTGCGGAATTTGCGGCTTYGGCAGGTGGGTGAAGAGGGG	PUS1
GCGGGGATCCAAAGGAAAGTYGGAAGCCATCATCACACCAC	PUS1
GGCGAGTCCTTTGCACATGTYGGCAACACACGCATCCGCAT	PUS1
TGCTCAGCTATGTCTGCGATYGGCAGAAGATGCACCAAACT	PUS1
TTTTGCTGGTTATAAAGGTTYGGATTGGAGAGGGCTCACTG	PUS1
TACTACTAGAAGGGAGCTTTYGGTGGTAGATCCCCTGGTGT	PUS1
TCCCTTAGCTATATGAATTTYGGCATGTTTCAGAGAGATCA	PUS1
CTTTCCAACATTTTTGTTATYGGCAAGGTAAGTCTGGGTTT	PUS1
AGCGCTGCCTGAAATAGGGTYGGCGCATACCCACCCCCGCC	PUS1
TTAAGGACATTCTTTTTTATYGGCGGCTCCATGGCCCTCGG	PUS1
CTCCACCTCCTCCTCCTCCTYGGGGAAAGGGGCCCGGAGAA	PUS1
AGATGATTCCATTCTCCGATYGGCCAAGGCCGATGGCATCG	PUS1
CAGTTACATATTATTGAAGTYGGCACACCACCTACAGGGAA	PUS1
TTCTCGGGTATCTTGAGGGTYTGTGATCCTGAACCCTTAAA	PUS1
CCTCCTGTGACCTCAGGGTTYGGCCCATGGGGCCCCCCCAG	PUS1
CTGGTGTCCAATCTGGATTTYGGAGTCTCAGACGCCGATAT	PUS1
TTCCTCCTTTCTCTGTATATYGGGCTCAGAGAGTACACTGT	PUS1
AGAGGAAATATTTAACATATYTGGGTCCAACTTCAATAATG	PUS1
ATTTACAACTCCATCTACATYGGTTCCCAGGACGCTCTCAT	PUS1
CAGGAACTCTTTGCTGAATTYGGAACGCTGAAGAAGGCGGC	PUS1
CTCAGAAGACAAGGGCGCTTYGGCTAAGCTGGTGGAAGCTA	PUS1
TGAAATTGAATTGAAGAAAAYTGCACGTAATCACCCAAATG	PUS1
TGAACACTTCTGAAAGTTTTYGGAAACTTAGAAAAGAGGGA	PUS1
AGGCCTAAGAATTTTGGCATYGGACAGGACATCCAGCCCAA	PUS1
TACTCAAGTTGTGACAGGGTYGGCAGACAAGAAAGAGGGCT	PUS1
TTTTGTCTTAGAATTTCACTYTGAACCCAATGAATATTTTA	PUS1
AGCCTGCTTAAAAGAGATTTYGGGGCAAAAACTCAGAATGG	PUS1
GAAGAAGCCTTTTCTGTGTTYGGCCAGGTAGAGAGGGCTGT	PUS1
GGGTAGCAGCTCCAAAGCATYGGATGCTGGATAAATTGACC	PUS1
AATTGCCAAGAATCTCATCTYGGCAGGAGTGAAAGGACTGA	PUS1
GTTATATCCTCCAGGAATATYGGCCAGAGGGCTGTGCTGAA	PUS1
AGAGAGCCGGATTCACTGTTYGGCTCGATATTATAAGACCA	PUS1
CCCCAAGTGAACTCAAGATTYGGCAGCCCCAGAGATGCCAA	PUS1
CCTTCAAGTATGCCTGGGTAYTGGATAAACTGAAAGCAGAG	PUS1
TGTCCTTAAGTTTGCTCGCTYGGTCAAGTCCTACGAAGCCC	PUS1
TTAACCTGAAAGATATCATTYGGGTCAGAGCTCCCCTCCCT	PUS1
AGGAGGATGCCTTCTACAGTYGGGAGAGTAGCAAGGACCCC	PUS1
ATAGAAATTTCTGAATAAATYGGCAGAAGAACGCAGACAGA	PUS1
AGACAATGGGGGGATTCCTTYGGCACACCCACCTGGCCCCA	PUS1
TCAGGAACGTACCCTGGCTTYGGTAGACACAGGCATTGGCA	PUS1
GAATAAGCTTTCCGATTTGTYGGCACCCATCTCAGAGCAGA	PUS1
GGTATTGGTACTGTTCTTGTYGGCCGAGTGGAGACTGGTAT	PUS1
CCAGCCCATCATAGACCAGTYGGCTGAGGAGGCACGGGCCT	PUS1
TTTAAGCTCAAGCAAATGTTYGGTAATGCAGACATGAATAC	PUS1
GAGACGGGGTTTCACCATGTYGGTTAGGCTGGTGTTGAACT	PUS1
CAGAAAGAGTTTTCTCCATTYGGTACAATCACTAGTGCAAA	PUS1
CATTAAGGCTGTGGATAGCTYGGTGCCAATTGGTCGTGGTC	PUS1
GTTGGGGCGAGGGGCGGACTYGGTGGGTGTCGGGACGACGC	PUS1
GCAGCTGCCATGGATGGATTYTGGGGGAACATGGCGACTCA	PUS1
AGAGACTGGCAGACACAAGTYGGACAGTGGTAAAGAGCTGA	PUS1
GTAGAAATTAAGACGTTTCTYTGCAAAACAAGGAAATCACA	PUS1
CCCTTATCTGGAAAGAAGTTYGGAAACCCTGGGGAGAAATT	PUS1
CATGTTTGGCAGCTGAGTATYGGAGCCAGGAGCCTGCCATG	PUS1
TCTCAGCTGGAGATCAATTTYGGAGACCTTGGCCGCCCAGG	PUS1
TAAGACCTCCCTGTGGTAATYGGGAGAGGTAGCCGAGTCAC	PUS1
TATCAGGTCTCGAATTTATTYGGAAGGGAAAATAGACTATG	PUS1
CGTATGTTGTCAGGTGGCTTYGGATATAGCCCCTTCCTCAG	PUS1
AAATTATAAACTTTTATACTYGGGTAAGTCCCCCAGGGGCG	PUS1
TGGCCTGCAGTATCTCTTCTYGGTGAGTAGGAATAGGTGGT	PUS1
CCCAGCATTCATTTTTCTGTYGGCATCTCCCCATGCTCACA	PUS1
GGAACTCTGGGTCTCGCGGTYTGGGAGCGCTACTCGCCAGG	PUS1
CATATGGAAGCAACTTTTTTYGGTGTCTCAAAGGAGTAACT	PUS1
GTTTCTCTTTCCTTAGTGTTYGGTGCTGGCACCAACTCGGG	PUS1
TTGGATGTTGCCAACAAAATYGGGATCATCTAAACTGAGTC	PUS1
CTGCTTCCCTCCTGCTCATTYGGGGCTGCCACCAGCTCTCC	PUS1
CTGAACCACCTGGGGGAGATYGGCACCAAGACCACACTGAG	PUS1
GAATTTTTTTCCTTTAGTGTYGGGCAACCATTCCAAGGGGC	PUS1
TAAATCTGTCTTGTAGGTTTYGGAACTGAAAGAACACAAAC	PUS1
CCTGTCATTGTCAGAGGAATYGGCAGGTATTCCCGATCTGC	PUS1
CCATTCAGTTTGAATCTGCTYGGGCACTCACTAACATTGCT	PUS1
TCGCCTCGCGCCGGCAGTTTYGGGCCTACACCTCCCCTCCC	PUS1
TTTGTGGCTTCCTTCGTTATYGGAGCCAGGCCTACACCCCA	PUS1
TTTGCTGGTTGTTTATTTTTYGGTACAACCAGAAAATAGTG	PUS1
CTCGGTCAGGTCTGGGAGAAYTGATCTTGCCTGAAAATGAA	PUS1
CCTGGCCTCCAGCACCTACTYGGTCCCGCGCGCTCCCTCGT	PUS1
GATCGAGGTGGAGATTCTATYGGTGAAACACCGACTCCTGG	PUS1
TTGAATAAAAGGGAATGTTTYGGCACCTGATATAATCTGCC	PUS1
AAAACATGGAGTTGTTCCTTYGGCCACATATATGCGAATCT	PUS1
TTGGGTTTTTTCTATAGGTTYGGCGGGGGGCCACAGGGAGG	PUS1
TTTCCCTTGCTGCGGTTGCTYGGGTGGGACAACAAGTCCAC	PUS1
GAAAGTTATCAGGAAGAATTYGGTCAAAAAATGCTTAGAAC	PUS1
CCTTAGTGTTCCTTGCATTTYGGGACAGAATGGAATCTCAG	PUS1
ACTTTTTCATTACGTGGGTTYTGAAATCTAGCCCCAGACAT	PUS1
CTTTGTGGCCTGTGGGGGGTYGGACAACATCTGCTCCATCT	PUS1
AACATCTCCCCCTTCTCCTTYGGGCTGGTCATCCAGCAGGT	PUS1
CCCAAGCATCAAATTCTGCTYGGACAATGGAGCCAAGTCGG	PUS1
CGCCAGGCCTTTGCCCCCTTYGGCCCCATCAAGAGCATCGA	PUS1
GCTACGGGACTACCTGAGCTYTGGGGGTCGGAGGCCCCCTC	PUS1
TCTGGAATTGTGGAAGTGGTYGGAAGAGTAACCGCCAAGGC	PUS1
TGATCATACTGGGCAGGCGTYGGCGTGGGGTCGGACACCCC	PUS1
CATCATTCGTCAGCGACAATYGGACAGAAAGGCTCTGGAAA	PUS1
CTCTTCCCACCCTTCAAGCTYGGAATCCACGAAGACTCCAC	PUS1
ATCTATGCCTATGATAACTTYGGCGTGCTGGGCCTGGACCT	PUS1
TGTTTTTCGAAGGATAATTTYGGAGGCAGAAAAAATGGACG	PUS1
GAGTTTTTCATCTTAGAGATYGGTGAACAAGTGTGAGGGTG	PUS1
TTTACATCCAAACATCACTTYGGCTTCGAAGCCGCCGCCTG	PUS1
AACTTTAGAAACTGTTCCTTYGGAGAGGAAAAAGGTACTCT	PUS1
TGTGGTCTCTTTGGGGCCGAYTGGGAGAAAGAGAAATCAAT	PUS1
CTGGAAGGGGCTGGGCTCTAYTGGGGGCCACTGAGCGCCGC	PUS1
GATGGCAAGCATGTGGTGTTYGGCAAAGTTCTAGAGGGCAT	PUS1
GAAAGGGGTTCAGGAGGTTTYGGTTCCACTGGAAAGAATTA	PUS1
TCTCTTGCTTCAACAGTGTTYGGACGGAACAGATCCGGGGA	PUS1
CAAAGGATTCCAGCAGATTTYGGCAGGTGAGATTTTGAGTA	PUS1
AATTGATAAAGAAGGTGTGAYTGAACCAGACACTGATGCTC	PUS1
GTCTATGTCAATGATGCTTTYGGCACTGCTCACAGAGCCCA	PUS1
AGCGGGTACAGAATGGATTTYGGAAGAGGGAGTCACCACTG	PUS1
TGGGGAAAAGAGACCATCCTYGGTCCCTAAGCCTCCAGAAA	PUS1
ATTATTTTGAAACTTTGCTTYGGGTTTGTGGCACCCTGGCC	PUS1
CCATTCCATGTCTAATATATYGGGATGGCATCACCTTCTGT	PUS1
TGGTTTTTATTCTGCTTATTYGGTTGCTGAGAAAGTAACTG	PUS1
CCCTGGTTTAACTAGCCTGTYTGGTAAGTAACTGAATATTT	PUS1
CAGACAGCCCCGAAGATTTTYGGAGGTGAAATCAAGACTCA	PUS1
TCAGATACTTACATAGTTTTYGGGGAAGCCAAGGTGAGTAA	PUS1
TCTGCTTTTTTTTTTTCAGTYGGACTAAATGCTCTTCCTTC	PUS1
CCAGGAGAAAGTGGAATCTTYGGAACAGGAAGCAGCCAACG	PUS1
GTAGCGTGGATAGCTGTGATYGGTGAGTCAACCGTCTGTGG	PUS1
CGCTGCAAGTCCAAAAAGTTYGGAGGTCCTGGTGCCCGTGC	PUS1
TTCCTTGAAGAAATACAGCTYGGTGAAGAGTTACTAGCTCA	PUS1
GGGGTCTAGGAGGGGCATTTYGGAGACTGCCTGACACCACC	PUS1
GTGGTTCTAGCCAGGCAGCTYGGAGAAGGCGCAATACTCTC	PUS1
AGGCGGACGACTAGAGTCGTYGGGCCCGGCGCGACCCGCAG	PUS1
GAAGCTGTTTCCTAATAGTTYGGACCAGACAGACATGCACG	PUS1
TGCAGAATATGCTAAACTTTYGGCCAAGAGAATGAAGGTTA	PUS1
TGTGTGTGGTTCCTTCTACTYGGGGATCATGCAGAGAGCTT	PUS1
ACATGAAGTTTGGTGCATCTYGGTTTATGCTGGCTCAACTG	PUS1
ATAACCACAAAAATAATGAAYTGATGAGAAATACAATGAAG	PUS1
GAGGTGATTTTCATATTGAAYTGCAAATTCGAAGAAGCAGC	PUS1
CTCACGATCCTTCTGACCTTYTGGGTTTTAAGCAGGAGGTG	PUS1
GTTGATTAAGTCCCTGCCCTYTGTACACACCGCCCGTCGCT	PUS1
CACAGCCAAGGGAACGGGCTYGGCGGAATCAGCGGGGAAAG	PUS1
GGTGCATGGCCGTTCTTAGTYGGTGGAGCGATTTGTCTGGT	PUS1
GGAACCGCAGGTTCAGACATYTGGTGTATGTGCTTGGCTGA	PUS1
CAGCAGCACATATACTAAAAYTGGAACGATACAGAGAAGAT	PUS1
GTGGCCTAATGGATAAGGCAYTGGCCTCCTAAGCCAGGGAT	PUS1
AAAATGGCTGAGTGAAGCATYGGACTGTAAATCTAAAGACA	PUS1
TAGCTCAGGTGGTAGAGCATYTGACTGCAGATCAAGAGGTC	PUS1
AAAGGATAACAGCTATCCATYGGTCTTAGGCCCCAAAAATT	PUS1
AACCACTTGGAGAAGTTGTTYGTGACAAACGATGCAGCAAC	PUS1
AAAGACTATTTTACTAAATTYGGAGAGGTCGTTGACTGTAC	PUS1
CTTATACACAATTCATTCTTYGCAGCTAATTAAGCCGAAGA	PUS1
GGAAGGGGCAGTGATGCCTTYGAGGGGAAGGAGGAGCCCCT	PUS1
AAAGCTCAGCTGGTGGTGATYGCACACGACGTGGATCCCAT	PUS1
ATGCAGACGGACGAAGAGATYGGGAAGGTGGCGGCGGCGGT	PUS1
AGCGAAAAGCTGTTGTAGTTYGCCCAAAAGATGAAGACTAT	PUS1
GATGATGGATTCTGTGTGTTYGAGAGCAACGCCATTGCCTA	PUS1
ACCCCATGGCTTCCATCTTTYGCATCACCACCACTCCTGAA	PUS1
CTAGATCTTGTGGAGAATTTYGATGAGGCTTCCAAGAATGA	PUS1
ATCTCCTCAGATGGCCAGTTYGCCCTCTCAGGCTCCTGGGA	PUS1
TTGGCTCATGAAATAGGTTTYGGAAGTAAAGTTACAACACA	PUS1
GACAAAGTATTTTGTCCATTYGAGATTCTGCACTCCATGAA	PUS1
TGCATGCAATTGTGTAGGATYGACAAGGAACTCAGATAAAA	PUS1
CAGAGCAGGCTGGAGGGATTYGCCACACAGCCCCACCCTTG	PUS1
TTTGATACTCAACTCATTATYGAAAAGGCCGAACATGGAGA	PUS1
TTGCTGCAGCTTAAAATGATYGGAATCAAGAAGGTACAGGG	PUS1
GCCGGCAAGGCGGCTCTGTTYGTGAGCAACAACAGCCGGCG	PUS1
ATTTTCCATTCTAAAAGTTTYGGAGAGGGAAATCCAGGCTA	PUS1
CGCGTCTCCTTTGAGCTGTTYGCAGACAAGGTCCCAAAGAC	PUS1
GCTGTCTATTTGTTCCCTTTYGACAGACTGCAACCCTGGTA	PUS1
AGGAGGTTTTTATTTCCCTTYGTGCGGGTGGCTGGGGCCGG	PUS1
CTGTGCAGCCGAGCTCGTTTYGAGAGGTAAGACCCATTCTT	PUS1
ACATCAACGATGCTTGGGTTYGCACCAATGACATGTTCAGG	PUS1
CAAGAAGTATGATGCGTTTTYGGCCTCAGAGTCTCTGATCA	PUS1
CACAGTCTGCTCCTTTTTTTYGTCCGCCACACGTAACTGAG	PUS1
CCCCCACTGTGGTGGTATATYGTGACCAGACCCCGGGAGCG	PUS1
CCTAATTCTTCTGCTCTGTTYGGGAAGACGTGGAGGAAAAG	PUS1
CCAGACCATTAATTTGATTTYGGATGAAAGCCATGAACGAG	PUS1
TGGTTGGGCCTGGTTGACTTYGCCAGTCAGCTCCTACAGTG	PUS1
TTCCACACATTTAAAACATTYGAAGGACCTAAATTCGTAGC	PUS1
CACGGGAAAGTAGAGATAATYGCCAATGATCAGGGAAACCG	PUS1
TTGGATGAGGATACAGGATTYGGTCTCTTTGACTAATCACC	PUS1
TCATTCATATTTGCCAGTATYGCTCACTTCAAAGAAACTCC	PUS1
TTTGCTAGGTCTGTTCTTTTYGAAGCTCCCCATGTCTAACT	PUS1
CTTCTTTTTGCAGGCAAGATYGTGGCAGAGCGTCCTGGCAC	PUS1
CGAGGGAGAGAGTTTTCCTTYGGTAAGTAAGCGTTTTATTT	PUS1
GATTTTTCTTCCTTTTTCTTYGCACACCAGCTCTACTCTTT	PUS1
CCACCGTTCCCAGGTGGGTTYGCAAGCACATCAAGAAGCCC	PUS1
TTGAGATGTATGAAGGCTTTYGGTCTCCCTGGGAGTGGGTG	PUS1
ACATGGCCCGCAGTGGCTTTYGCCCCAGAAAGGGGAAAGGA	PUS1
GGATTCCATGTTCATGAGTTYGGAGATAATACAGCAGGTGG	PUS1
CCTCTCCTTGCCAGGTACTTYGACCCAGCCAACGGCAAGTT	PUS1
GAGTGCAGCTATTGGAGCTTYGCAGGAGGCAAGTGAGGCCT	PUS1
GAGGAGAAAGCCAAGGAGATYGCGAAGATGGCAGAGATGCT	PUS1
GTGTAAATGTTGAGCCTTTTYGGCCTGGCTTGTTTGCAAAG	PUS1
GTCGCCAATATGCAGCTCTTYGTCCGCGCCCAGGAGCTACA	PUS1
TTGTTTTGTATAGTATTTATYGATTCAGGAAACAAACACAA	PUS1
AAATTTACATCATTTCTTTTYGGGAGAGACTTGTTTTGGAT	PUS1
AGCAGCTGGACTGGGGCCTTYGGCACAGCAGCCGGTGTCTC	PUS1
GCCCTGCTCACGTACATGATYGCGCACATCACGGGCCTGAA	PUS1
CTTGGGGGTGTTCCTCTATTYGCCTGCCACCTCTCTTGTCT	PUS1
GAAAATAAGGAAATTTCTTTYGACACAATGCAGCAAGAACT	PUS1
AGACCAGACAACTTTGTATTYGGTGAGTTATACAGATGATA	PUS1
ACTCTTAAGGAAAAACTCATYGCACCAGTTGCGGAAGAAGA	PUS1
TTGCAGGATTGGTCTTGATTYGAGCAATGGTAAACCTCGAG	PUS1
AACAACCTGCTTGGCAAGTTYGAACTCACAGGCATACCTCC	PUS1
ATAAGTACCTATCGCAGTTTYGAAGTCGTTTCTCCCCAACT	PUS1
TTTGAGCGCTCGCCGTCTTTYGGCGGCAGCGGCGACGCGAG	PUS1
GAGAGCCTGAGGAGCCATTTYGAGCAATGGGGAACGCTCAC	PUS1
CCGGCTCATAAAGGTTCATTYGGACAAAGCACAGCAGAACA	PUS1
GATAGCCAGGGCTGTTGTTTYGGGGCCCTTCAAGGCAAAAG	PUS1
ACCTAAAGTTCTTATGAGATYGTCCAAAACAAAGAAACATG	PUS1
GATAAATTGACCGGTGTGTTYGTAAGTATCTTATATAAATA	PUS1
GTACAGGAAATTACTTCATTYGACAGGAGTATGTACAGAAA	PUS1
GACCAGCAGCGTCTGATATTYGCCGGCAAACAGCTGGAGGA	PUS1
TATGCCAAAGATGTAAAATTYGGTGCAGATGCCCGAGCCTT	PUS1
TCTCCGTGCATTTGTGCCTTYGGAACAGAGCCAAACGCCGT	PUS1
TCTGCATTTTTAAAACAGTTYGGCCATAATCCTAGATGCAC	PUS1
TGAATTCCCAGAGTTTCAATYGTAAACAAAAATGACTAAAT	PUS1
TGTCCAGCTGTAAGTTCATTYGAGTAGCAGACCTAACAAAT	PUS1
CATGCTCTGGTGGCTGGAATYGACCGCTACCCCCGCAAAGT	PUS1
CCCACCGTGTTCTTCGACATYGCCGTCGACGGCGAGCCCTT	PUS1
GCACCACCCCACTTCCATTTYGGCCAAACCAACCGCACCTC	PUS1
AGAAGGCAGAGGCTTCCTTTYGGACCGCCGAGGAGGTAATC	PUS1
AGTCCTATGGCATGAATGTTYGCCAACCAACCCCAGGAAAA	PUS1
CTCTTACAGAGAGGCGGATTYGGTCGTGGACGTGGTCAGCC	PUS1
AGACCAGACAATTTCGTGTTYGGTGAGTGCCTGGTGTGGCT	PUS1
GTGTTGAGGAAAGCAGACATYGACCTCACCAAGAGGGCGGG	PUS1
GGTGAAATTGCCTCTACCTTYGATCACCCAGAACTGGTGAA	PUS1
CGGATGAAGCTGACAGTGATYGACACACCAGGGTTCGGGGA	PUS1
CTGGACCGTCTCAAGGTGTTYGACGGCATCCCACCGCCCTA	PUS1
ACCTTGAACAAGTTCAATTTYGCCAGGAACAGTACCCTCAA	PUS1
TTCGAGTTCCAAGCAACATTYGCTCCTGCCCTGGGGCCAGC	PUS1
AGTAGCCAATGTTTCTCTTTYGGCCCTATACAAAGGCAAGA	PUS1
AAGGTCAGGGTCAGTGGATTYGGTCGTATTGGGCGCCTGGT	PUS1
GCAAGAAGAGATTGCCTTTTYGAAGAAACTCCACGAAGAGG	PUS1
GCAATGTATCCTGATTACTTYGCCAAGAGAGAACAGTGGAA	PUS1
TCAAGTTGGTGGAGGCCCTTYGTGCTGAACACCAAATCAAC	PUS1
AATTCAAAGGTTCCTGAAATYGAGGTCACCGTGGAAGGTAA	PUS1
CTGGGAGATGTTTTTTGTATYGCTCAGTCATACCGGGCAGA	PUS1
ATTTTTGTAAATGCCTTAATYGAAAACCCAACCTTTGACTC	PUS1
GAATACTAATCCATTCCTTTYGGCCCTGCAGCATGTCGTGC	PUS1
TCTTAGTTCAACTTTAAATTYGCCCACAGAACCCTCTAAAT	PUS1
AGCCAATGGTATGTTTTGATYGACATCAAGTGGAGACGGGA	PUS1
AAGCTGAAACTTAAAGGAATYGACGGAAGGGCACCACCAGG	PUS1
TTCCTATTTCTGCAGCGATTYGAACACTCAGCCAAGCTGCG	PUS1
GTGAAGAAGCTGTATGACATYGATGTGGCCAAGGTCAACAC	PUS1
TTGGGCATTCAGTTGGATTTYGAAAAGAACCAACTGAAGGA	PUS1
GCTCGCCTGGACCACAAGTTYGACCTGATGTATGCCAAGCG	PUS1
GCGTTCCCCCAGTGTGTGTTYGACCACTGGCAGATCCTGCC	PUS1
CTCAGAGATGACTCCTCTATYGAGAAACTTGCCAAGAACAA	PUS1
ACCCCAAGTGACGTAGATTTYGTACGGCTCACGCCGGCCGG	PUS1
AATCTGTTCGCTTCATTCATYGCCCCCACAATCCTAGGTCT	PUS1
CATGCTGTCTCTAGACTTTTYGGACGATGTGCGGCGGATGA	PUS1
CCTGGTATGGTGGTCACCTTYGCTCCAGTCAACGTTGCAAC	PUS1
AGTGCCAGGTCCTTGCCCTTYGTGGAAAGTCACAGGTCACA	PUS1
TCCAATGAATTTTCTGTAATYGCTGACCCAAGAGGAAACAC	PUS1
GAGAGGCACCCTGGATCTTTYGACGTGGTTCACGTGAAAGA	PUS1
CGGGCTCCCTTTGACCTTTTYGAGAACAAGAAGAAAAAGAA	PUS1
ATCCGTCAAGCTGGTGTCATYGACTAACCACATCCACAAAG	PUS1
CACTACAGTGGCAATAATATYGAACTGGGCACAGCATGCGG	PUS1
AATTTCTTTCCTAGGCCGTTYGAGCAAGGAAGACATTGAAC	PUS1
GCCGGATGGAACTTTGGGATYGGTAATAAAACTGCAGTGCC	PUS1
ACCTGTCTGGTGAGTTTGTTYGGACAACCTAACTCAGCTTT	PUS1
CAGTGCTTTGTGAGCTTTTTYGACCTGCGGGATCCGAGCCA	PUS1
GGCTAGATCCCCGGTGGTTTYGTGCTCAAAATAAAAAGCCT	PUS1
TAAGGAAATGCTGAAGCTTTYGGTAAGTGTTTGCTGGATTC	PUS1
TGTCTCTCTTGGATGATGTTYGCCGTCAGCATTCACCAAAT	PUS1
ATGGTTTGCAACTCCGATTTYGCACACCGCTCCACCGTGCC	PUS1
GAGAACAACGAACGGGTGTTYGACCACAAGCAGGGCACCTA	PUS1
GCTTTGTGTCCGCGAGTTTTYGTTCCGCTCCGCAGCGCTCT	PUS1
GATGCCAAGATTCGCATTTTYGACCTGGGGCGGAAAAAGGC	PUS1
TCTTCTTCAATATGTGAATTYGGGCTCACAGAATCAAAGCC	PUS1
ACCCCTGGAAAGACACCAATYGGCACACCAGCCATGAACAT	PUS1
TCGCTCCTCCACCAGTTTATYGCGACGTAGCATCCAGGCCT	PUS1
AGCTGCGGAATTTGCGGCTTYGGCAGGTGGGTGAAGAGGGG	PUS1
TTTTCTCAACAGGTTATTATYGCAGCAGAACTCCTAAAAAA	PUS1
CGCCGCCTCCATGCTGAGTTYGCTGCGGAACGAGACTGGGA	PUS1
GATCGCCTCTTTGACATTTTYGCCAAAATACCACTAGTGGA	PUS1
TTCAAGAAGTACGAGGAGATYGACAATGCCCCGGAGGAGCG	PUS1
TTCCTGAGGAACATGCGCTTYGCCAAGAAGCACAACAAAAA	PUS1
TGCTCAGCTATGTCTGCGATYGGCAGAAGATGCACCAAACT	PUS1
TTTTGCTGGTTATAAAGGTTYGGATTGGAGAGGGCTCACTG	PUS1
TACTACTAGAAGGGAGCTTTYGGTGGTAGATCCCCTGGTGT	PUS1
TCCCTTAGCTATATGAATTTYGGCATGTTTCAGAGAGATCA	PUS1
CTTTCCAACATTTTTGTTATYGGCAAGGTAAGTCTGGGTTT	PUS1
AAGAGAATTAATGTGCGTATYGAGCACATTAAGCACTCTAA	PUS1
TCTGCACCAGCTAAAAAGTTYGCAGAGACCCAACCTAAAAA	PUS1
GCCTTGGATCAGGAGATTATYGAAGTAGATCCTGACACTAA	PUS1
TGTTTCTTTCTAGTGGTCTTYGTAAGAGTGTAGAAGCATTC	PUS1
TTAAGGACATTCTTTTTTATYGGCGGCTCCATGGCCCTCGG	PUS1
GATCTGCCTTCTTCCTGTTTYGCTCTGAACATCGCCCAAAG	PUS1
CAGGAGAAGCCAAAAATGTTYGCCAAGGGAACTGAGATCAC	PUS1
TCCCATGTTCTGGCTTTCTTYGCAGCAAGCGATGGCATAGT	PUS1
GGGTGAGCTGGTGCCTGCTTYGACGGGCCAGGCCCTGGAGG	PUS1
GATGAGTTGGTGCCCCTTTTYGAGAAGGCCGGACCCATTTG	PUS1
GTTAATTGAGAATAGAAATTYGCCCCTGGCAAATGCACACA	PUS1
CGTGCCTCTGGCCAGGCTTTYGAGCTGATCTTGAAGCCACC	PUS1
CGGTGGCATCTACGGGGTTTYGAACAGGAAGCGGGGCCACG	PUS1
AGATGATTCCATTCTCCGATYGGCCAAGGCCGATGGCATCG	PUS1
TCGTCCATCCCATCTTCCTTYGCCCCCAGGAAAGGACGCAT	PUS1
AGGAGAAAAATGTGCCTGTTYGCAGGCTTCCAGCGAAAAGC	PUS1
ATCCCTTCAGAGATGGAGTTYGATCCTAACTCCAACCCACC	PUS1
CCTCCTGTGACCTCAGGGTTYGGCCCATGGGGCCCCCCCAG	PUS1
GCTGGCACGGCCTTTGACTTYGAGAACATGAAGCGCAAACA	PUS1
TGCCAGTGTCACAACAACATYGACACGACAGACCCAGAAGC	PUS1
CTGGTGTCCAATCTGGATTTYGGAGTCTCAGACGCCGATAT	PUS1
TGGAGGGCCGCTGCCTCAATYGCAGCAGCGGCTCCAAGCGA	PUS1
CAGTGAAGATGTTTACTCATYGCCCCCACCTCTGGTCCACA	PUS1
TTCCTCCTTTCTCTGTATATYGGGCTCAGAGAGTACACTGT	PUS1
GACAACGTCTGCATGGCCTTYGCAGGTATGAGTCGGTGGGG	PUS1
TACGTCCTGGAGGACTCTATYGTGGACCCACAGAATCAGAC	PUS1
AGTAACAACCTTATTATCATYGAAACGGACCACAATGCCTA	PUS1
AAATACGATGACGAGGAGTTYGAGTATCGACATGTCATGCT	PUS1
ATTTACAACTCCATCTACATYGGTTCCCAGGACGCTCTCAT	PUS1
GATTGTAGTCCCATTCAGTTYGAATCTGCTTGGGCACTCAC	PUS1
CAGGAACTCTTTGCTGAATTYGGAACGCTGAAGAAGGCGGC	PUS1
GCCTATCTCGTTGGCCTTTTYGAAGACACCAACCTGTGCAC	PUS1
CTCAGAAGACAAGGGCGCTTYGGCTAAGCTGGTGGAAGCTA	PUS1
CAAATGATCTATGAAGAGTTYGTACAAATGATGACAGCAAA	PUS1
CTCCCTCTCCAGATTGAGTTYGTGACGGGCACCAAAAAAGG	PUS1
CTTTCTGTAGTTGCAGCATTYGCAAGAAGAAGCAGAATAGA	PUS1
GCCAGGTGATCAGAGTTATTYGCATCCTCAGCCACCCCATC	PUS1
CAAGTTTGATATGTTTGTTTYGAAAGTAGCGTTGGAAGAGT	PUS1
TGAACACTTCTGAAAGTTTTYGGAAACTTAGAAAAGAGGGA	PUS1
TAGATTTCCTTCATGCCAATYGCATCGTTCACCGAGATCTG	PUS1
CTATGCACAAACAGTAGTTTYGTGTGTTGGCTGCTCCACTG	PUS1
GTGTTAACCAGCTAAAATTTYGCTCGAAGCCTTCAGTCCGT	PUS1
AGGCCTAAGAATTTTGGCATYGGACAGGACATCCAGCCCAA	PUS1
AAGAGTTGTTGGGGGTTTTTYGCATCCATAGCACTGGTTAC	PUS1
AATGGAAACATCCAAAAATTYGTCACAGAATTTTGAGACCC	PUS1
AGCCTGCTTAAAAGAGATTTYGGGGCAAAAACTCAGAATGG	PUS1
GAAGAAGCCTTTTCTGTGTTYGGCCAGGTAGAGAGGGCTGT	PUS1
GGGTAGCAGCTCCAAAGCATYGGATGCTGGATAAATTGACC	PUS1
GTTATATCCTCCAGGAATATYGGCCAGAGGGCTGTGCTGAA	PUS1
ACCATGATTGAACCTCACATYGATGTCAAGACTACCGATGG	PUS1
GCTCACATTGCATGCAACTTYGCTGAGCTGAAGGAAAAGAT	PUS1
ACTTTCTCTTACGCTGGGTTYGAAATGCAACCCAAAAAGTA	PUS1
GGTGTGGGCTTGTGGGTCTTYGAGACCCGAAAATTGAGAGC	PUS1
CAGTGGCTGAGTTCTTCCTTYGACAAGATGGCGGCAGGAGG	PUS1
GATCACAGGATAGGTATTTTYGCCAAGAGAGCCATCCAGAC	PUS1
AGAGAGCCGGATTCACTGTTYGGCTCGATATTATAAGACCA	PUS1
CACATCACCCTGTGGAAGTTYGAGACCAGCAAGTACTGCAT	PUS1
CCCCAAGTGAACTCAAGATTYGGCAGCCCCAGAGATGCCAA	PUS1
AAATACAAGGAAGAAACAATYGAGAAGATGCAGGAATAAAG	PUS1
GTATTTGAATGGGAAGCTTTYGCCCGGGGAACCAAAGCTCT	PUS1
TGGTTATTTCCTAAGAATATYGAAAGTGAAGCAACTATGTG	PUS1
TTAACCTGAAAGATATCATTYGGGTCAGAGCTCCCCTCCCT	PUS1
GGTTCTCCAGTTCAAATTATYGCAAAGTAAAGGATCTTTGA	PUS1
ATAGAAATTTCTGAATAAATYGGCAGAAGAACGCAGACAGA	PUS1
TTAACTACAGTGTTTTCCTTYGCACCGATCCCCACCCCAAT	PUS1
AGACAATGGGGGGATTCCTTYGGCACACCCACCTGGCCCCA	PUS1
CAGTTAAGGTGAATATGTATYGTATCACAAAACAAACCCAA	PUS1
TGCAAAGAGATCTGGAAATTYGCCATGAAGGAGATGGGAAC	PUS1
TCAGGAACGTACCCTGGCTTYGGTAGACACAGGCATTGGCA	PUS1
GACCCCTTGGTGGGAAGTATYGCCACTCAGTATATGACCAA	PUS1
CCAGATCACTGTTAATGATTYGCCTGTGGGACGCTCCGTGG	PUS1
ATGTATGCAAAGCATGCCTTYGTTCACTGGTACGTGGGTGA	PUS1
CAACATTTTTAACTCTCATTYGACAACCTACTACTAATCAC	PUS1
TTTAAGCTCAAGCAAATGTTYGGTAATGCAGACATGAATAC	PUS1
GGTATTCACATGGGTCAGTTYGTGTATTGCGGCAAGAAGGT	PUS1
AACATTTATTCATATTGTTTYGATTACCCTCGTGTTACTAC	PUS1
CCCTTCACATCCACAGATTTYGCAAACCCCCTCATCCTGCC	PUS1
AAAAGAATCATGGAGAAATTYGAGAAGGAGGCTGCTGAGAT	PUS1
TGCAAAGTGAGAAAAATCTTYGTGGGCACAAAAGGAATCCC	PUS1
TGGCTATGAGAGAGATTTTTYGCGATACTTACAGAGCTTAC	PUS1
CAGAAAGAGTTTTCTCCATTYGGTACAATCACTAGTGCAAA	PUS1
GTGAATATTGTGCCTGTCATYGCAAAAGCTGACACTCTCAC	PUS1
AAAATACATGTCTTCTACATYGACTACGGCAACGTGAGTGT	PUS1
TCTAGAGCTTTGGCTGAAATYGCCAAAGCCGAACTGGATGA	PUS1
AGAGCTAAATCTTGAGATTTYGCCCCCGGTAAGCATAAAGC	PUS1
CCCTTATCTGGAAAGAAGTTYGGAAACCCTGGGGAGAAATT	PUS1
CATGTTTGGCAGCTGAGTATYGGAGCCAGGAGCCTGCCATG	PUS1
TCTCAGCTGGAGATCAATTTYGGAGACCTTGGCCGCCCAGG	PUS1
CTTTGAACAGAAGGATCGTTYGAGTCAGTCCAAAGCCTCAA	PUS1
TTTTTTTTTTTTTGGATCTTYGCAAGGGCAAAACTACAAGT	PUS1
CTGCTGCTGGAGCACTCATTYGAGATCGGTGAGTCAGGCAA	PUS1
TAAGACCTCCCTGTGGTAATYGGGAGAGGTAGCCGAGTCAC	PUS1
TATCAGGTCTCGAATTTATTYGGAAGGGAAAATAGACTATG	PUS1
CGTATGTTGTCAGGTGGCTTYGGATATAGCCCCTTCCTCAG	PUS1
AGCTTTTCAGTCCAAATCTTYGCAAGGCTCAAAATGCCACA	PUS1
CATATGGAAGCAACTTTTTTYGGTGTCTCAAAGGAGTAACT	PUS1
GTTTCTCTTTCCTTAGTGTTYGGTGCTGGCACCAACTCGGG	PUS1
GGATTTGCTTTTGTCACCTTYGAAAGCCCAGCAGACGCTAA	PUS1
CTTGTGAGTCCTGCATCATTYGAAAATGTCCGTGCAAAGGT	PUS1
TTGGATGTTGCCAACAAAATYGGGATCATCTAAACTGAGTC	PUS1
CTGCTTCCCTCCTGCTCATTYGGGGCTGCCACCAGCTCTCC	PUS1
ATCTTCTACAACTCCTCCATYGAGGAAATGCCCCTCAATGT	PUS1
GCCACCCATGCTGGTGCCATYGCCCCATGTGAAGTCACTGT	PUS1
CAGTGTCTTGGGAAATTTATYGAGATTGCTGCCCGAAAGAA	PUS1
CTGAACCACCTGGGGGAGATYGGCACCAAGACCACACTGAG	PUS1
AGGATTCGTTTTCCTGGCTTYGAGCCCCTCACACCCTGGAT	PUS1
CCTCCCCCAGGGACCTCATTYGACAAGAGTTCGCACACCTG	PUS1
ATAAGCTCCAGTTTTCGTATYGCAAATAAGACTCTTACCTA	PUS1
ACCACCATGTATCTGGGAATYGCCGACAGGATGCAGAAGGA	PUS1
TAAATCTGTCTTGTAGGTTTYGGAACTGAAAGAACACAAAC	PUS1
GTGTCTACTGAAGATCCCTTYGACCAGGATGACTGGGGAGC	PUS1
TTGGTCAGAAATTACCTTTTYGACACAAGCCTACTGAATGC	PUS1
CCTGTCATTGTCAGAGGAATYGGCAGGTATTCCCGATCTGC	PUS1
GTGGATAATTCATTTGAATTYGAAAAACGTAGAAATGAACC	PUS1
CTTCTGAGATAAGAACCATTYGTGTAACACCAACACTTAAC	PUS1
TCGCCTCGCGCCGGCAGTTTYGGGCCTACACCTCCCCTCCC	PUS1
TTTGTGGCTTCCTTCGTTATYGGAGCCAGGCCTACACCCCA	PUS1
TTTGCTGGTTGTTTATTTTTYGGTACAACCAGAAAATAGTG	PUS1
CCAACTCTTGCTGGTTTCTTYGCTGGAGCACTTGAGCCACG	PUS1
TATAAAGCTGCTAGTGATATYGCAATGACAGAACTTCCACC	PUS1
ATGTCATCATATGCATTTTTYGTGCAAACTTGTCGGGAAGA	PUS1
GATCGAGGTGGAGATTCTATYGGTGAAACACCGACTCCTGG	PUS1
GAGGCTACGTGAAGGAAGTTYGCCTGGAGACATTTCTACTG	PUS1
TTGAATAAAAGGGAATGTTTYGGCACCTGATATAATCTGCC	PUS1
AGGCTAAAAAGTATATTTATYGCAGAGGATGTTCATAAGGC	PUS1
GGGCCGTGAGTGTGCGCTTTYGAGAGTCGCGGCGGAAGGAG	PUS1
AAAACATGGAGTTGTTCCTTYGGCCACATATATGCGAATCT	PUS1
TTGGGTTTTTTCTATAGGTTYGGCGGGGGGCCACAGGGAGG	PUS1
TTTGTGTACCCTCTTGATTTYGCCCGTACCCGTCTAGCAGC	PUS1
AAGACCCTTTTTCCTCTGATYGAAGCCAAGAAAAAGGATCA	PUS1
AACCAAAGAGCAGCGGAGTTYGAGAAGCCAGCAGCTCGGGG	PUS1
CCGCTCTGTGGATGAGACTTYGAGACTAGTTCAGGCCTTCC	PUS1
GCCCCCGCTAACCGGCTTTTYGCCCAAATGGGCCATTATCG	PUS1
ATATGGGATCTAAATAATTTYGCAACCCCAATGACACCAGG	PUS1
CCTGCGGCAGCATTGGCCTTYGCAGCGGCGGCAGCAGCACC	PUS1
TCTTACAGCAAACTGTAGTTYGCCTCCAAGACACCATTGTC	PUS1
ACAACACCCATTTTTCCTTTYGCCGACCCCAAGAGTTTTGG	PUS1
GAAAGTTATCAGGAAGAATTYGGTCAAAAAATGCTTAGAAC	PUS1
CCTTAGTGTTCCTTGCATTTYGGGACAGAATGGAATCTCAG	PUS1
AAATCTAAGAATATCCTCTTYGTCATCACAAAACCAGATGT	PUS1
CCCCAGCTGGACTTGAGTATYGACAGCCTGGATCTGAGCTG	PUS1
AACATCTCCCCCTTCTCCTTYGGGCTGGTCATCCAGCAGGT	PUS1
CGCCAGGCCTTTGCCCCCTTYGGCCCCATCAAGAGCATCGA	PUS1
AATGCAGCTCTGCACGAGTTYGAAACCGTCATACCTCCTTC	PUS1
TTGGAGGGGTTTCGTGTGTTYGACAAGGAGGGGAACGGCAA	PUS1
CATGGTGGTTACTCTGTGTTYGCTGGTGTTGGTGAGAGGAC	PUS1
TTGATGGACTCTTTGAGTTTYGTCAGCTCTCAACTGGCGGT	PUS1
AGGGGCACGAGGCGCGCGTTYGCACCCGAGCCCGGCCCGCG	PUS1
CTTGATCGACTTGCCTACATYGCCCACCCCAAGCTTGGGAA	PUS1
GTTTTTTAGGTCTTTGACTTYGAACTGAGCAGCCAGGATAT	PUS1
GCTAGCTGCCAAAAGCTCATYGAAGTGGACGATGAACGCAA	PUS1
TTTGAATAAATGTCACTTTTYGAGGCAAAAGAAGGAACCGT	PUS1
CATCATTCGTCAGCGACAATYGGACAGAAAGGCTCTGGAAA	PUS1
GATGAGGGGCCTCTGGCTTTYGTGAGTGCAATATTGTTTTT	PUS1
TGTTCCACTTATAAATTTTTYGAGGTTATCCTCATTGATCC	PUS1
ATCTATGCCTATGATAACTTYGGCGTGCTGGGCCTGGACCT	PUS1
TGTTTTTCGAAGGATAATTTYGGAGGCAGAAAAAATGGACG	PUS1
GAGTTTTTCATCTTAGAGATYGGTGAACAAGTGTGAGGGTG	PUS1
GGGATTTTGGCACAGGAAATYGTGAAGGTAAAACATCACTG	PUS1
TCTTTTAAAATTTTTTGTTTYGCATCCGAAACCGAAAGAAA	PUS1
TTTTTCGACATCAGGGTATTYGTTCCACCTTGGCCAGGCCT	PUS1
AAAAACTAACATTGAAATTTYGAAACAGCAGCAGAGTGAGT	PUS1
TTTACATCCAAACATCACTTYGGCTTCGAAGCCGCCGCCTG	PUS1
TACTTGGTGTTTTTTGGTTTYGTGAAACGGCCGTCCCAAAA	PUS1
ATACAATTGACCCAATAATTYGACCAACGGAACAAGTTACC	PUS1
AACTTTAGAAACTGTTCCTTYGGAGAGGAAAAAGGTACTCT	PUS1
TTTCAATTCCGGTTGATTTTYGTCCCTCTGCGCTTGCTCCC	PUS1
TAAGGATCATCAAAATTTTTYGAGACTCCTCACAGAAACTG	PUS1
GATGGCAAGCATGTGGTGTTYGGCAAAGTTCTAGAGGGCAT	PUS1
GTGAAAGAGGTTCAGAAATTYGTCAACAAAGGAGAAAAAGG	PUS1
TTGCAGATGTGGCTCGCTTTYGTAACCGCTACCCTAATATC	PUS1
AGTGGAGCCACTTTCTGTATYGTTACATGGACATATGTAAG	PUS1
GAAAGGGGTTCAGGAGGTTTYGGTTCCACTGGAAAGAATTA	PUS1
TCTCTTGCTTCAACAGTGTTYGGACGGAACAGATCCGGGGA	PUS1
CAAAGGATTCCAGCAGATTTYGGCAGGTGAGATTTTGAGTA	PUS1
AAAATATTTCCTCAGTACTTYGCAGAAAACACCAAACAAAA	PUS1
AGGGGAGAGAGGCTAAAGATYGTGACCCCGGCTCTCCAAGG	PUS1
AGACAACACTTTATCAGTTTYGACACTGACAGGAGTGGAAC	PUS1
GTCTATGTCAATGATGCTTTYGGCACTGCTCACAGAGCCCA	PUS1
AGCGGGTACAGAATGGATTTYGGAAGAGGGAGTCACCACTG	PUS1
GAAAAGACTCATATCAACATYGTCGTCATTGGACACGTAAA	PUS1
ATTATTTTGAAACTTTGCTTYGGGTTTGTGGCACCCTGGCC	PUS1
CCATTCCATGTCTAATATATYGGGATGGCATCACCTTCTGT	PUS1
TACCACATGCAGCGCTGCATYGACTCTGGCCTCTGGGTCCC	PUS1
TGGTTTTTATTCTGCTTATTYGGTTGCTGAGAAAGTAACTG	PUS1
AAGTTCAATGCTGATGAATTYGAAGACATGGTGGCTGAAAA	PUS1
CAGACAGCCCCGAAGATTTTYGGAGGTGAAATCAAGACTCA	PUS1
TCAGATACTTACATAGTTTTYGGGGAAGCCAAGGTGAGTAA	PUS1
GATGAGGATGAAGATGAAATYGAACCAGCAGCGATGAAAGC	PUS1
AACTACAAGACCGCCCCTTTYGACAGCCGCTTCCCCAACCA	PUS1
GCCCGAGGACTCTTGGAGTTYGAGCATCAGAGGGCCCCTAG	PUS1
CCAGGAGAAAGTGGAATCTTYGGAACAGGAAGCAGCCAACG	PUS1
CTGGAAAACCTGGAAAAAATYGAAAAGGAACAGAGCAAACA	PUS1
GTAGCGTGGATAGCTGTGATYGGTGAGTCAACCGTCTGTGG	PUS1
CGCTGCAAGTCCAAAAAGTTYGGAGGTCCTGGTGCCCGTGC	PUS1
GGGGTCTAGGAGGGGCATTTYGGAGACTGCCTGACACCACC	PUS1
TTACTTTTAACCAGTGAAATYGACCTGCCCGTGAAGAGGCG	PUS1
GAACTTGATGCACTGGAAATYGAGACAGTACAAAAGGAGAC	PUS1
AATGTAGATTCTCTGGTCATYGAGCATATCCAAGTGAACAA	PUS1
AACGTACCTGTCAAGCTCTTYGCCCGCTCCACAGCTGTCAC	PUS1
CTCCTCCTCAAGTTCCTTTTYGCACCGTCACCACCCAACAC	PUS1
GAAGAAGTGGAGAAGCGCTTYGAGGGTCGGCTCACCAAGAA	PUS1
GAAGCTGTTTCCTAATAGTTYGGACCAGACAGACATGCACG	PUS1
TGCAGAATATGCTAAACTTTYGGCCAAGAGAATGAAGGTTA	PUS1
GGAATATCCATGTACTTGTTYGCAAGCAGGACTTTGAGGCA	PUS1
ACGGTGCCCCCCGGGACCTTYGACACCCGGGGGTCTGAGGG	PUS1
AAAATGGCTGAGTGAAGCATYGGACTGTAAATCTAAAGACA	PUS1
CGGACCAGAGCGAAAGCATTYGCCAAGAATGTTTTCATTAA	PUS1
GTGGAGCCTGCGGCTTAATTYGACTCAACACGGGAAACCTC	PUS1
AAAGGATAACAGCTATCCATYGGTCTTAGGCCCCAAAAATT	PUS1
