Y_extendSeq_20nt	class
GTCGTGGTGGGCGCTTTGGTYCCAGAGGAGGCCCAGGAGGA	non-PUS3
CATCATGCCCAACAAGAGGTYCTATACCTTTTAATGAATTG	non-PUS3
GGGGGGCAGTCAGGGCTGGTYCGAATCCATTTTGTCCGTGG	non-PUS3
TTAGCTCCCTGCTCTACGGTYCCATCCCCAAGGCGGCCGTC	non-PUS3
GGAAGGCGTTCAGTCAGAGTYCGAGCCTCTGCATCCACCAG	non-PUS3
CAAGAACGAAAGTCGGAGGTYCGAAGACGATCAGATACCGT	non-PUS3
TGTCTCACCAGTGCCTGGGTYCCAGCCCCAAGACGAGAGTC	non-PUS3
TCCTTTGTTTTCTTGCCAGTYCGATCCTTTGGTACAGAAGA	non-PUS3
CTTCGTCACTTAATGTTGGTYCCAGTCCTTCAACTGTTCAT	non-PUS3
TGGCAAGAAGAAGGTCTGGTYAGACCCCAATGAGACCAATG	non-PUS3
ATGTATTTTACGTACAAGGTYCGCTACACTAACAGCTCCAC	non-PUS3
GAAGATATGACCTATGCAGTYCGAAAACTGGATAACACTAA	non-PUS3
CTTTGTGGCCTGTGGGGGGTYGGACAACATCTGCTCCATCT	non-PUS3
TCTGGAATTGTGGAAGTGGTYGGAAGAGTAACCGCCAAGGC	non-PUS3
GCTGGTCATTCAGCAGGTGTYCGACAATGGCAGCATCTACA	non-PUS3
CTAATGCCAGGGTCGAGGTTYCGATCCCCGTACGGGCCTTT	non-PUS3
TGCATGTATGAGGCCTCGGTYCGATCCCCGACACCTCCAAG	non-PUS3
TTCACTGCCGCGGCCCGCGTYCGATTCCCGGTCAGGGAATG	non-PUS3
GTAAACAGGAGATCCTGGGTYCGAATCCCAGCGGTGCCTCC	non-PUS3
ATAATCTGAAGGTCCTGAGTYCGAACCTCAGAGGGGGCAAG	non-PUS3
CCCATGCGGGAGACCCGGGTYCAATTCCCGGCCACTGCACG	non-PUS3
GTAAACCAGGGGTCGCGAGTYCGATCCTCGCTGGGGCCTCC	non-PUS3
CTGTCTAGCGACAGAGTGGTYCAATTCCACCTTTCGGGCGG	non-PUS3
GCAATCCTTAGGTCGCTGGTYCGATTCCGGCTCGAAGGACT	non-PUS3
GCATGCGAGAGGTAGCGGGAYCGATGCCCGCATCCTCCACT	non-PUS3
CAGATCAAGAGGTCCCCGGTYCAAATCCGGGTGCCCCCTTC	non-PUS3
TGTGCTCTGCACGCGTGGGTYCGAATCCCACCTTCGTCGAC	non-PUS3
TTGGATTCTCAGGGATGGGTYCGATTCTCATAGTCCTAGAA	non-PUS3
GTAAACCGAAGATCACGGGTYCGAACCCCGTCCGTGCCTGA	non-PUS3
TGAAACCAGCTTTGGGGGGTYCGATTCCTTCCTTTTTTGTC	non-PUS3
TGGGGTCTCCCCGCGCAGGTYCGAACCCTGCTCGCTGCGGA	non-PUS3
TTAATCTGAGGGTCCAGGGTYCAAGTCCCTGTTCGGGCGTC	non-PUS3
CGGATCAGAAGATTGAGGGTYCGAATCCCTTCGTGGTTAAG	non-PUS3
CAGATCAGAAGGCTGCGTGTYCGAATCACGTCGGGGTCAAA	non-PUS3
TTAACCGAAAGGTTGGTGGTYCGATCCCACCCAGGGACGGA	non-PUS3
GGCATTCAAAGGTTCCGGGTYCGAGTCCCGGCGGAGTCGTA	non-PUS3
TTAATCTCAGGGTCGTGGGTYCGAGCCCCACGTTGGGCGCT	non-PUS3
AGCGAAAAGCTGTTGTAGTTYGCCCAAAAGATGAAGACTAT	PUS3
GCCATTCCTTGGGGCATTTCYGCCACTGCAGCCCTCAGGCC	PUS3
CTAAAACCCCTAAGTGAGGTYGCCCAGGGGGTTGTCCCCAG	PUS3
GGAATTCCCAAACTCGATGAYGCCAATGATGCAGGTATATA	PUS3
CAGACTGTCAAGAACAAGTAYGCCACATCGAAGCATGCTAA	PUS3
ATCTCCTCAGATGGCCAGTTYGCCCTCTCAGGCTCCTGGGA	PUS3
CAGAGCAGGCTGGAGGGATTYGCCACACAGCCCCACCCTTG	PUS3
CTTTTTACCCTCTAGATGGTYGCCACCCTGGGGACCACAAC	PUS3
GGAGGTAACAAGAAATACCGYGCCCTGAGGTTGGACGTGGG	PUS3
AGGAGGCATGCCAGGAGGAAYGCCTGGGGGATTTCCTGGTG	PUS3
TCTTCTGGAGCTCAACTTCTYGCCAACCACAGGGACCAAGC	PUS3
ATGTTTCACTTTCTAGCTGGYGCCGACAAGAAAGCCGAGGC	PUS3
GGGTTGTTTTTGTTTTTTCTYGCCAGGTAGATAAAACTGAC	PUS3
TGGTTGGGCCTGGTTGACTTYGCCAGTCAGCTCCTACAGTG	PUS3
CACGGGAAAGTAGAGATAATYGCCAATGATCAGGGAAACCG	PUS3
GCTCATGTGGAGTATAGCACYGCCGCCCGCCACTACGCCCA	PUS3
GCCATTCTGGGGGTGTCCCTYGCCGTCTGCAAAGCTGGTGC	PUS3
ACATGGCCCGCAGTGGCTTTYGCCCCAGAAAGGGGAAAGGA	PUS3
CTTTGCTGATTCCGATATAGYGCCCCCAGCCAGTACCTGGG	PUS3
GGTGAAGTCGGTGCCACTTCYGCCCTGGCCCCCAAGATCGG	PUS3
CTGAGCGGTTGTGGCCGCGTYGCCGACCTCCAGCAGCAGTC	PUS3
CTTGGGGGTGTTCCTCTATTYGCCTGCCACCTCTCTTGTCT	PUS3
CCTCATCTGGTGACTCATGAYGCCCGCACCATCCGCTACCC	PUS3
TCTAGTTGCTGGTTCTTACAYGCCACCATCCACAGTCCTTC	PUS3
GACCAGCAGCGTCTGATATTYGCCGGCAAACAGCTGGAGGA	PUS3
AGACAACAAGCAGCCTATTAYGCCCAGACAAGTCCCCAGGG	PUS3
CCCACCGTGTTCTTCGACATYGCCGTCGACGGCGAGCCCTT	PUS3
TCGGCGCCCACCTCGGCCGCYGCCTCCCCGTTGTCGGCGGC	PUS3
AGTCCTATGGCATGAATGTTYGCCAACCAACCCCAGGAAAA	PUS3
CTGAGGAACAGACTTAAGTAYGCCCTGACAGGAGATGAAGT	PUS3
ACCTTGAACAAGTTCAATTTYGCCAGGAACAGTACCCTCAA	PUS3
ACCTCCTGCAGGGAGCCTTCYGCCACCAGCCCCTCCCCAGA	PUS3
TGGACCCCAGGCCCGGGCCCYGCCCACCTGAGCTGGGCCTG	PUS3
ACTGCTTCCATGTTGGCATCYGCCCCTCCTCAAGAGCAAAA	PUS3
GCAATGTATCCTGATTACTTYGCCAAGAGAGAACAGTGGAA	PUS3
CTTTCATGCCTCTGATCATGYGCCCAAGCCAGGAGTGCCAA	PUS3
GTCGCCTCCTACCTGCTGGCYGCCCTAGGGGGCAACTCCTC	PUS3
TCTTAGTTCAACTTTAAATTYGCCCACAGAACCCTCTAAAT	PUS3
GCTGGATTGTCTCGTTTTCCYGCCAAATAAACAGGATCAGC	PUS3
AATCTGTTCGCTTCATTCATYGCCCCCACAATCCTAGGTCT	PUS3
CTTCTCAGGGTTGGAAATTGYGCCAAACGGGATCACATTGC	PUS3
TCCTATTGCTCGGGCTGTAGYGCCCTCGAAACGTCAGCGTG	PUS3
GATTACGATGCTTTGGATGTYGCCAACAAAGTAAGTTTCCT	PUS3
TGTCTCTCTTGGATGATGTTYGCCGTCAGCATTCACCAAAT	PUS3
ACCCAGATTAGTGTGAGCCTYGCCAAAGATGAGCCTGACAC	PUS3
GGCCCAGCAGGGAGCTCGTAYGCCGCTCGTGCCTGAAGCAG	PUS3
AACCTTCTGCTGTGTATGTAYGCCAAGGAGACCGTGGGCTT	PUS3
TGCGCTCCTCTCCGCAGATAYGCCAGCCTCTACTTCTGCTG	PUS3
TTTCCACTTAACGCAATTTAYGCCAAACCTGCAAACAAACA	PUS3
GATCGCCTCTTTGACATTTTYGCCAAAATACCACTAGTGGA	PUS3
TTTCCGCGTACAGAAGTGCTYGCCCGGGGAGTCCCGCCTGA	PUS3
TTCCTGAGGAACATGCGCTTYGCCAAGAAGCACAACAAAAA	PUS3
ATCTTCATTGATGAGTTGGAYGCCATCGGCACCAAGCGGTA	PUS3
AAAAAAATTACTTATTTTCTYGCCCCATACATACCTTGAGG	PUS3
GGCTGTGTAGACACCAGCGTYGCCCCCCGCCAACCTACTCA	PUS3
CAGGACTAGGGACAGGGCTGYGCCGGCCTGGGCCAGGGCCC	PUS3
GATGGCGGCGCCGGGGGCGCYGCCTCCTCGGCCGCCGCCTC	PUS3
GGCCGCTACCTGACGGTGGCYGCCATCTTCCGGGGCCGCAT	PUS3
TCTCGGTGCCGAAGATTGCCYGCCAGAGGACTGACCACAGC	PUS3
CAGGAGAAGCCAAAAATGTTYGCCAAGGGAACTGAGATCAC	PUS3
GTTAATTGAGAATAGAAATTYGCCCCTGGCAAATGCACACA	PUS3
TCGTCCATCCCATCTTCCTTYGCCCCCAGGAAAGGACGCAT	PUS3
CAGTGAAGATGTTTACTCATYGCCCCCACCTCTGGTCCACA	PUS3
GTTTGGTAGCGTATCCAGTAYGCCAAGACCGACTCAGATAT	PUS3
AAAACAGCCTTTACCATCCCYGCCATTAAGGGTGTGGGCCA	PUS3
AGGAGTGCGAGCACTGCGACYGCCTGCAGGGCTTCCAGCTC	PUS3
TGATTTTGAGCGGCACTTCCYGCCAGCCAGTCGAAATCGGA	PUS3
GCACAACCTCAAGGCTAAGAYGCCCAAGAAGGGGAAGCCCC	PUS3
ACCTGGATATAAATTAATTGYGCCTGCCACCACCATCCAAC	PUS3
GATCACAGGATAGGTATTTTYGCCAAGAGAGCCATCCAGAC	PUS3
CTCTGAGCAGAAGATGGCTGYGCCACCCACGTATGCCGATC	PUS3
GAAGTTGAGTTGATGAAAGTYGCCAGAGCACATCCCAAAGC	PUS3
GTATTTGAATGGGAAGCTTTYGCCCGGGGAACCAAAGCTCT	PUS3
GCCAAAAGGGTCATTACCTCYGCCCCCTCTGCTGATGCCCC	PUS3
TGCAAAGAGATCTGGAAATTYGCCATGAAGGAGATGGGAAC	PUS3
GACCCCTTGGTGGGAAGTATYGCCACTCAGTATATGACCAA	PUS3
CCAGATCACTGTTAATGATTYGCCTGTGGGACGCTCCGTGG	PUS3
TTTTCCTTCCCAGCTTCTGTYGCCACCGGGCCAGACTCCCC	PUS3
GCGTCTTCCTCTTCTCCTTAYGCCAGGATGCCGAGCTACAG	PUS3
CGATTTAGACCTGCGGGTGCYGCCCCACGTCCCCCACCAAA	PUS3
TCTAGAGCTTTGGCTGAAATYGCCAAAGCCGAACTGGATGA	PUS3
GTTTTCTTCATTTTCATAGTYGCCAACCATCATAGCTGACA	PUS3
AGAGCTAAATCTTGAGATTTYGCCCCCGGTAAGCATAAAGC	PUS3
GATAGCAACTGGATCGTGGGYGCCACGCTGGAGAAGAAGCT	PUS3
TCCATCTTGTTTCATTTGCTYGCCCCGCCCCCGAGACGGAG	PUS3
GCTCTCAAGAGCATCAACAAYGCCGAAAAGAGAGGCAAACG	PUS3
TAGGTTGTTCAACAGTGTTGYGCCAGCCTACAGGAGGAAAG	PUS3
CAAAATCTGCATGTGGCGTGYGCCCAGGCAGACTTCGAGGG	PUS3
CAACAAAACTGTGTCTTATCYGCCAGGAAAGACCAGCCTCA	PUS3
CTGGATATAAATACTGCCTAYGCCAGACTCAGAGGAATCGA	PUS3
GCCACCCATGCTGGTGCCATYGCCCCATGTGAAGTCACTGT	PUS3
ACCACCATGTATCTGGGAATYGCCGACAGGATGCAGAAGGA	PUS3
TGAGGCGCCGCCATTTTTGCYGCCCGGACGCGGAGCGAGAG	PUS3
CCTATTCGCTGCACTAACTGYGCCCGATGCGTGCCCAAGGA	PUS3
CGAGCTGTTGTCTTCCTGCCYGCCCTGTGTCGTAAAATGGG	PUS3
GTTCTTGTATGTGGAAGGCTYGCCAGAGGGGATTCCCTTCC	PUS3
GGATGAGGTTTTGAAGATTAYGCCAGTGCAGAAGCAGACCC	PUS3
GAGGCTACGTGAAGGAAGTTYGCCTGGAGACATTTCTACTG	PUS3
TTTGTGTACCCTCTTGATTTYGCCCGTACCCGTCTAGCAGC	PUS3
ACTGACTTGATTTTTCATTCYGCCACTCCATCTTCAAACCC	PUS3
GCCCCCGCTAACCGGCTTTTYGCCCAAATGGGCCATTATCG	PUS3
TCTTACAGCAAACTGTAGTTYGCCTCCAAGACACCATTGTC	PUS3
ACAACACCCATTTTTCCTTTYGCCGACCCCAAGAGTTTTGG	PUS3
TTCTATATTGGTCATTGCCTYGCCAAACAGGAGCTCCAGCA	PUS3
TTGTCAAGGGGCTCAGGCTGYGCCGGCCAAAGGCCAAGGCC	PUS3
AAAATCAGGATTTTAGTGCTYGCCACCACCAGATGAGAAGT	PUS3
GCCAGGAAGTACAAGCAGGCYGCCAAGTGCCTCCTGCTGGC	PUS3
GGTGCAGACGGAGGCCCCCGYGCCTGTCAGCGTGCAGCCCC	PUS3
CTTGATCGACTTGCCTACATYGCCCACCCCAAGCTTGGGAA	PUS3
GTGCCCATGTACAAGGGGCAYGCCCTCCCCCATGCCATCCT	PUS3
TTGGCCACAGAGGACTCACTYGCCCACACCGAGGGCGACCC	PUS3
GGGGCTGTGGCCGTCTCTGCYGCCCCAGGCTCTGCAGCCCC	PUS3
CGAGGCTCTGAGCGAAGCTCYGCCCGGCGACAACGTCGGCT	PUS3
CGGCTGTCCTCCCGTTCCGCYGCCCGCCCTGCCACCATGAC	PUS3
CGCTAAGAGAGTCACCATCAYGCCCAAAGACATCCAGTTGG	PUS3
AAAAGGAAAAATTTTATCACYGCCATCACAGCAGGTTTCCT	PUS3
TTATTTGCTGCTGTTTAAGTYGCCAACCTCCCCTCCCAATA	PUS3
AAGCGGATGGTGGTTCCTGCYGCCCTCAAGGTCGTGCGTCT	PUS3
GGCCAGGAAGTGGTGTTTGTYGCCGAGCCAGACAACAAGAA	PUS3
TACTATGTGACTATCATTGAYGCCCCAGGACACAGAGACTT	PUS3
GGCTGCCGTTCCAGCTGGACYGCCGCCATGGAACTCAGCGC	PUS3
TTTGGTGTTGGCTTTTATTCYGCCTACTTGGTGGCAGAGAA	PUS3
AACGTACCTGTCAAGCTCTTYGCCCGCTCCACAGCTGTCAC	PUS3
CCGCTGATTTTCCCAGCTGCYGCCCAATAAACCTGTCTGCC	PUS3
ACTGGCAATAAAGTTTTTGGYGCCCTGAAGGGAGCTGTGGA	PUS3
CAGCAGTACATGCAGAGCAAYGCCGAGGTTGTGAGTTCGAG	PUS3
CGGACCAGAGCGAAAGCATTYGCCAAGAATGTTTTCATTAA	PUS3
GAGGGCCTGCTATGGTGTGCYGCGGTTCATCATGGAGAGTG	PUS3
ACACTGTGAGTTTGCCTACCYGCGGGACCTTCTCATCAGGT	PUS3
GGACCTCGGACCTTGGAGCCYGCGGGGTGCCTCGGCCCCTC	PUS3
GAGGAGAAAGCCAAGGAGATYGCGAAGATGGCAGAGATGCT	PUS3
GTGTAACACAGATTCTCCTCYGCGCTATGTGGACATTGCCA	PUS3
GCCCTGCTCACGTACATGATYGCGCACATCACGGGCCTGAA	PUS3
CCATCTTTCTTTTCAGTCCTYGCGCACCGGGGAACAAGGTC	PUS3
CCACCCCAAGGGGCGGCTGCYGCGAGAAGAGCTCGCTGCGG	PUS3
CTTGTTTGCTTCGCCAGGGCYACGGGGACCACAAGCCCAAG	PUS3
GAGGCTCGCAGCCGTGGCCAYGCGTCCCCACTGGCGGCCAA	PUS3
TGTCCTTGTCGCCCAAACTCYGCGCGGAGAAAGAGGCGGCC	PUS3
GCAAGGCCGGAGTGAGTGCCYGCGGCCCCTCACAGGGCTGA	PUS3
TTCTCCGTGCAGGGATCCTGYACGACACGTACCCACTCTCG	PUS3
TCGCTCCTCCACCAGTTTATYGCGACGTAGCATCCAGGCCT	PUS3
GAGACTGCTGAGCCCGTCCGYCCGCCGCCACCACCCACTCC	PUS3
CCCATATTGTAACTTACTACYCCGGAAAAAAAGAACCATTT	PUS3
TACGCAGTTTTCTTTGGCTTYACGAAGCCGATTAAAAGACC	PUS3
GTCGTGTGTTCTGGATTCATYCCGGCACCACCATGTAAGTG	PUS3
CTCCCGTTCCCTCTTCCGCTYGCGCTGCCGCAGGTGGGCCC	PUS3
GGACAAGGCAGTGGAGTCCTYACGGGCCATCTCACACGAGC	PUS3
AGACGAGTTAAGTCCTGGTCYGCGTGGAGGTCGACGACTCC	PUS3
TTCCGGATTTCCTTGGGTCTYCCGGTAGGAGCTGTAATCAA	PUS3
TATTTTCTTTCAGTTAATGCYGCGGACAACAAACAAAGGGA	PUS3
CCTCGCCCTCCTGCCCTGGGYGCGGCCCCCCGGGTCCCGGC	PUS3
TTCTGTGCTTAGAACATTTTYACGGACCTAAGCGCTGGAGA	PUS3
TATGTTCTGATCTGGAATCCYGCGGCGGCGGCGGCGGCGGC	PUS3
TGGGCCCTGGGCTTCTACCCYGCGGAGATCACACTGACCTG	PUS3
GTTGGCAAGAACAAGAGCCTYACGAAAGGCGGCAAAAAGGG	PUS3
CATGATATGAGACAGACACTYGCGGTGGGTGTCATCAAAGC	PUS3
TTGCTCGATGTCTTGGTAAAYACGGCATCATCTGCATGGAG	PUS3
CAGATTTCCATAAAAACCCTYACGGGGAAGACCATCACCCT	PUS3
CAAGCTCTCCATTGTCCCCGYGCGCAGAGGCTACTGGGGGA	PUS3
GAGACATCATCTTCAAATTCYACGAGTCCAAGTACGCCTCA	PUS3
GGTGTTTGAGAAGCCCCCACYGCGGGTGAAGAACTTCGACA	PUS3
TTACTTCAAGAAGCAGCAGCYGCGGAAGCCCAGACACCAGG	PUS3
ACAAAGTGGAGTACACGCCTYACGAGGAGGGTGCGTGCTGG	PUS3
GTGACCTCCTGTCCCCATGGYACGTCCCACCCTGTCCCCAG	PUS3
TGGCTATGAGAGAGATTTTTYGCGATACTTACAGAGCTTAC	PUS3
GCATGGATCCCTATGATGGCYACGGTGAGGACAACGCCTCC	PUS3
TGGAAAACGATCTTTTGGATYACGATGAAGAGGAAGAGCCC	PUS3
GAGTCGCCCCGACCTTTCTCYGCGCAGTACGGCCGCCGGGA	PUS3
CCTTTTCCTTGCTCGGGTCCYGCGTCCGCGCCTGCCCCGCC	PUS3
GGTTCGGTACCACACGAAGGYGCGCGCCGGCCGCGGCTTCA	PUS3
GCGGTCCCTGAAGCCATCCCYACGCCCCGAGCTGCGGCCTC	PUS3
AGTCAGCCAAGATGTTTAACYACGCGGGATGGAAGAACACC	PUS3
CTCACTTTCCCTCCATTTGTYACGTGAGAGAATGCGTCTGC	PUS3
CCAGGAGGTGGTGGTGTGCAYGCGGAGGGACACAGCGCTGG	PUS3
GCGGGCCCGTGTTCACGGATYCCGGCATCCACATCATCCTC	PUS3
TCTGCAAAAAGAATTGAACCYGCGGAAGAGCTGAACAGCAA	PUS3
TGAACGAGTTTGGGGAGTCCYACGAGGAGAAGGCCACGCGG	PUS3
CCTTCCTGGGTATGGAATCTYGCGGCATCCACGAGACCACG	PUS3
GTTCCTGTGCCATGAGTTCCYGCGAGGGAACCCACGGGTGA	PUS3
GATGCTGGCTCAGGAAGTTCYGCGCATGCGTGGCACCATTT	PUS3
CTACCTCTATATCCGAATGCYGCGATCCCCAACCCTCTATG	PUS3
GAGTGGGGTCACCACGTGCCYGCGCTTCCCGGGCCAGCTGA	PUS3
ACTTTGCCAATGTGCTCACCYCCGACAACCACTCAGACTAC	PUS3
CCAAGACCGTGGCCTATTTCYACGACCCCGACGTGGGCAAC	PUS3
AAGAGGAGGAGGAGGAGGATYCCGAGGTGCAGGGGGAGCAG	PUS3
ATCCTAGAATCACTGAAGTCYGCGGGACAAGAGAACCTGGA	PUS3
GGGGCTGCACTGGACGTGTTYACGGAAGTAAGTGCCTGGCA	PUS3
GCGGTAAGGCTGGGAAGGACYCCGGAAAGGCCAAGACAAAG	PUS3
TGGGCAGACTAAGCCGATTTYCCGGAAAAAGGCTAAAACTA	PUS3
GGGGACATGCACGTGTGAGAYGCGGCAGCGGGCGGCGCGGA	PUS3
TGCTGCTGACTCTGTGCAGCYGCGCACCTGTGTCCCCCACC	PUS3
AGTGAAGGGTTTTCAATTCAYACGCGGGATAGCCCCAAATG	PUS3
TGCCTGCGGGCTTTCTGGTCYCCGGATGGAGGCGTGGGTTC	PUS3
CGATGAAGAACGCAGCTAGCYGCGAGAATTAATGTGAATTG	PUS3
GACCCCCTTCGCGGGGGGGAYGCGTGCATTTATCAGATCAA	PUS3
GGTATGATTCTCGCTTAGGGYGCGAGAGGTCCCGGGTTCAA	PUS3
ATGTACCTGTGATGATCACTYGGAATCCACACTGGTACCGC	non-PUS3
AAAGACTATTTTACTAAATTYGGAGAGGTCGTTGACTGTAC	non-PUS3
CAGCGCCGCGGAGCCTCGGTYGGCCTCGGATAGCCGGTCCC	non-PUS3
GCCGCCGCGGTTGATGTGGTYGGGCCGGGGCTGAGGAGGCC	non-PUS3
ATGCAGACGGACGAAGAGATYGGGAAGGTGGCGGCGGCGGT	non-PUS3
GATGGCTTTTGGTTGTATCTYGGAAGGACCAGAGCCCAGTC	non-PUS3
AACCATTTTAACTGTATTTTYTGCAGCCCGTACCTTCTTGG	non-PUS3
TTGGCTCATGAAATAGGTTTYGGAAGTAAAGTTACAACACA	non-PUS3
TTGCTGCAGCTTAAAATGATYGGAATCAAGAAGGTACAGGG	non-PUS3
ATTTTCCATTCTAAAAGTTTYGGAGAGGGAAATCCAGGCTA	non-PUS3
TGGCGGCGGTGGCGGACACTYGGGGTCTGGACGCAACGGCG	non-PUS3
CAAGAAGTATGATGCGTTTTYGGCCTCAGAGTCTCTGATCA	non-PUS3
AATAGCTTGCCTTTCTCACTYGGCAAGGAAGATGGAAGTGG	non-PUS3
CCTAATTCTTCTGCTCTGTTYGGGAAGACGTGGAGGAAAAG	non-PUS3
CCAGACCATTAATTTGATTTYGGATGAAAGCCATGAACGAG	non-PUS3
TTGGATGAGGATACAGGATTYGGTCTCTTTGACTAATCACC	non-PUS3
CGAGGGAGAGAGTTTTCCTTYGGTAAGTAAGCGTTTTATTT	non-PUS3
CAAAACAAATGTTAAATTCTYGGCTATTACGACAGACTGCC	non-PUS3
TTGAGATGTATGAAGGCTTTYGGTCTCCCTGGGAGTGGGTG	non-PUS3
GGATTCCATGTTCATGAGTTYGGAGATAATACAGCAGGTGG	non-PUS3
GTGTAAATGTTGAGCCTTTTYGGCCTGGCTTGTTTGCAAAG	non-PUS3
AAATTTACATCATTTCTTTTYGGGAGAGACTTGTTTTGGAT	non-PUS3
AGCAGCTGGACTGGGGCCTTYGGCACAGCAGCCGGTGTCTC	non-PUS3
CTCTTGTTTGTCATCTTATTYTGGGTGCTGGGGTGGCTGCC	non-PUS3
AGACCAGACAACTTTGTATTYGGTGAGTTATACAGATGATA	non-PUS3
CATCTAAACTTAGATGGAGTYGGTCAAATGAGGGAACATCT	non-PUS3
TTTGAGCGCTCGCCGTCTTTYGGCGGCAGCGGCGACGCGAG	non-PUS3
CCGGCTCATAAAGGTTCATTYGGACAAAGCACAGCAGAACA	non-PUS3
GATAGCCAGGGCTGTTGTTTYGGGGCCCTTCAAGGCAAAAG	non-PUS3
GTTGGGAGTTGCTTGGAGGTYGGCGGCGCGGGGCTGAAGGC	non-PUS3
TATGCCAAAGATGTAAAATTYGGTGCAGATGCCCGAGCCTT	non-PUS3
TTCTGTTTTTGTTACTTAGTYGGAGAAGGAACGAGAGAAGG	non-PUS3
TCTCCGTGCATTTGTGCCTTYGGAACAGAGCCAAACGCCGT	non-PUS3
TCTGCATTTTTAAAACAGTTYGGCCATAATCCTAGATGCAC	non-PUS3
TGCCCTTCACCTAGCTCCCTYGGCCAGGAGCGAGCGAAGCC	non-PUS3
GCACCACCCCACTTCCATTTYGGCCAAACCAACCGCACCTC	non-PUS3
AGAAGGCAGAGGCTTCCTTTYGGACCGCCGAGGAGGTAATC	non-PUS3
CTCTTACAGAGAGGCGGATTYGGTCGTGGACGTGGTCAGCC	non-PUS3
AGACCAGACAATTTCGTGTTYGGTGAGTGCCTGGTGTGGCT	non-PUS3
TCACCTGGCTGTCAACTTCTYGGTGTCATTGCTCAAGAAAA	non-PUS3
AGTAGCCAATGTTTCTCTTTYGGCCCTATACAAAGGCAAGA	non-PUS3
TCAATCCTCTCAGTTGTACTYGGAGACCTGCCTCCCAGCCC	non-PUS3
AAGGTCAGGGTCAGTGGATTYGGTCGTATTGGGCGCCTGGT	non-PUS3
GAATACTAATCCATTCCTTTYGGCCCTGCAGCATGTCGTGC	non-PUS3
TCGATGCCGGAAAAACACCTYGGCCCGCCGGAAGGGCAGGC	non-PUS3
AAGCAGAATTCACCAAGCGTYGGATTGTTCACCCACTAATA	non-PUS3
CATGCTGTCTCTAGACTTTTYGGACGATGTGCGGCGGATGA	non-PUS3
GCCTGTACTTGTCCACTGGAYTGAAGGCAGAGAAGGAAGGG	non-PUS3
TTTGATCTTTTGATTCCTCTYGGGCTGAAGCAGACCAAGTT	non-PUS3
TTGCCTTTCTGACATTTCCTYGGGAATCTGCAAGAACCTCC	non-PUS3
GCCGGATGGAACTTTGGGATYGGTAATAAAACTGCAGTGCC	non-PUS3
ACCTGTCTGGTGAGTTTGTTYGGACAACCTAACTCAGCTTT	non-PUS3
TAAGGAAATGCTGAAGCTTTYGGTAAGTGTTTGCTGGATTC	non-PUS3
GCAAGTGAGGCCTATCTGGTYGGCCTTTTTGAAGACACCAA	non-PUS3
TCTTCTTCAATATGTGAATTYGGGCTCACAGAATCAAAGCC	non-PUS3
ACCCCTGGAAAGACACCAATYGGCACACCAGCCATGAACAT	non-PUS3
TGCCCTCTGCTGTCACCACTYGGTCAGAAACTTCCAAACGC	non-PUS3
AGCTGCGGAATTTGCGGCTTYGGCAGGTGGGTGAAGAGGGG	non-PUS3
GCGGGGATCCAAAGGAAAGTYGGAAGCCATCATCACACCAC	non-PUS3
GGCGAGTCCTTTGCACATGTYGGCAACACACGCATCCGCAT	non-PUS3
TGCTCAGCTATGTCTGCGATYGGCAGAAGATGCACCAAACT	non-PUS3
TTTTGCTGGTTATAAAGGTTYGGATTGGAGAGGGCTCACTG	non-PUS3
TACTACTAGAAGGGAGCTTTYGGTGGTAGATCCCCTGGTGT	non-PUS3
TCCCTTAGCTATATGAATTTYGGCATGTTTCAGAGAGATCA	non-PUS3
CTTTCCAACATTTTTGTTATYGGCAAGGTAAGTCTGGGTTT	non-PUS3
AGCGCTGCCTGAAATAGGGTYGGCGCATACCCACCCCCGCC	non-PUS3
TTAAGGACATTCTTTTTTATYGGCGGCTCCATGGCCCTCGG	non-PUS3
CTCCACCTCCTCCTCCTCCTYGGGGAAAGGGGCCCGGAGAA	non-PUS3
AGATGATTCCATTCTCCGATYGGCCAAGGCCGATGGCATCG	non-PUS3
CAGTTACATATTATTGAAGTYGGCACACCACCTACAGGGAA	non-PUS3
TTCTCGGGTATCTTGAGGGTYTGTGATCCTGAACCCTTAAA	non-PUS3
CCTCCTGTGACCTCAGGGTTYGGCCCATGGGGCCCCCCCAG	non-PUS3
CTGGTGTCCAATCTGGATTTYGGAGTCTCAGACGCCGATAT	non-PUS3
TTCCTCCTTTCTCTGTATATYGGGCTCAGAGAGTACACTGT	non-PUS3
AGAGGAAATATTTAACATATYTGGGTCCAACTTCAATAATG	non-PUS3
ATTTACAACTCCATCTACATYGGTTCCCAGGACGCTCTCAT	non-PUS3
CAGGAACTCTTTGCTGAATTYGGAACGCTGAAGAAGGCGGC	non-PUS3
CTCAGAAGACAAGGGCGCTTYGGCTAAGCTGGTGGAAGCTA	non-PUS3
TGAAATTGAATTGAAGAAAAYTGCACGTAATCACCCAAATG	non-PUS3
TGAACACTTCTGAAAGTTTTYGGAAACTTAGAAAAGAGGGA	non-PUS3
AGGCCTAAGAATTTTGGCATYGGACAGGACATCCAGCCCAA	non-PUS3
TACTCAAGTTGTGACAGGGTYGGCAGACAAGAAAGAGGGCT	non-PUS3
TTTTGTCTTAGAATTTCACTYTGAACCCAATGAATATTTTA	non-PUS3
AGCCTGCTTAAAAGAGATTTYGGGGCAAAAACTCAGAATGG	non-PUS3
GAAGAAGCCTTTTCTGTGTTYGGCCAGGTAGAGAGGGCTGT	non-PUS3
GGGTAGCAGCTCCAAAGCATYGGATGCTGGATAAATTGACC	non-PUS3
AATTGCCAAGAATCTCATCTYGGCAGGAGTGAAAGGACTGA	non-PUS3
GTTATATCCTCCAGGAATATYGGCCAGAGGGCTGTGCTGAA	non-PUS3
AGAGAGCCGGATTCACTGTTYGGCTCGATATTATAAGACCA	non-PUS3
CCCCAAGTGAACTCAAGATTYGGCAGCCCCAGAGATGCCAA	non-PUS3
CCTTCAAGTATGCCTGGGTAYTGGATAAACTGAAAGCAGAG	non-PUS3
TGTCCTTAAGTTTGCTCGCTYGGTCAAGTCCTACGAAGCCC	non-PUS3
TTAACCTGAAAGATATCATTYGGGTCAGAGCTCCCCTCCCT	non-PUS3
AGGAGGATGCCTTCTACAGTYGGGAGAGTAGCAAGGACCCC	non-PUS3
ATAGAAATTTCTGAATAAATYGGCAGAAGAACGCAGACAGA	non-PUS3
AGACAATGGGGGGATTCCTTYGGCACACCCACCTGGCCCCA	non-PUS3
TCAGGAACGTACCCTGGCTTYGGTAGACACAGGCATTGGCA	non-PUS3
GAATAAGCTTTCCGATTTGTYGGCACCCATCTCAGAGCAGA	non-PUS3
GGTATTGGTACTGTTCTTGTYGGCCGAGTGGAGACTGGTAT	non-PUS3
CCAGCCCATCATAGACCAGTYGGCTGAGGAGGCACGGGCCT	non-PUS3
TTTAAGCTCAAGCAAATGTTYGGTAATGCAGACATGAATAC	non-PUS3
GAGACGGGGTTTCACCATGTYGGTTAGGCTGGTGTTGAACT	non-PUS3
CAGAAAGAGTTTTCTCCATTYGGTACAATCACTAGTGCAAA	non-PUS3
CATTAAGGCTGTGGATAGCTYGGTGCCAATTGGTCGTGGTC	non-PUS3
GTTGGGGCGAGGGGCGGACTYGGTGGGTGTCGGGACGACGC	non-PUS3
GCAGCTGCCATGGATGGATTYTGGGGGAACATGGCGACTCA	non-PUS3
AGAGACTGGCAGACACAAGTYGGACAGTGGTAAAGAGCTGA	non-PUS3
GTAGAAATTAAGACGTTTCTYTGCAAAACAAGGAAATCACA	non-PUS3
CCCTTATCTGGAAAGAAGTTYGGAAACCCTGGGGAGAAATT	non-PUS3
CATGTTTGGCAGCTGAGTATYGGAGCCAGGAGCCTGCCATG	non-PUS3
TCTCAGCTGGAGATCAATTTYGGAGACCTTGGCCGCCCAGG	non-PUS3
TAAGACCTCCCTGTGGTAATYGGGAGAGGTAGCCGAGTCAC	non-PUS3
TATCAGGTCTCGAATTTATTYGGAAGGGAAAATAGACTATG	non-PUS3
CGTATGTTGTCAGGTGGCTTYGGATATAGCCCCTTCCTCAG	non-PUS3
AAATTATAAACTTTTATACTYGGGTAAGTCCCCCAGGGGCG	non-PUS3
TGGCCTGCAGTATCTCTTCTYGGTGAGTAGGAATAGGTGGT	non-PUS3
CCCAGCATTCATTTTTCTGTYGGCATCTCCCCATGCTCACA	non-PUS3
GGAACTCTGGGTCTCGCGGTYTGGGAGCGCTACTCGCCAGG	non-PUS3
CATATGGAAGCAACTTTTTTYGGTGTCTCAAAGGAGTAACT	non-PUS3
GTTTCTCTTTCCTTAGTGTTYGGTGCTGGCACCAACTCGGG	non-PUS3
TTGGATGTTGCCAACAAAATYGGGATCATCTAAACTGAGTC	non-PUS3
CTGCTTCCCTCCTGCTCATTYGGGGCTGCCACCAGCTCTCC	non-PUS3
CTGAACCACCTGGGGGAGATYGGCACCAAGACCACACTGAG	non-PUS3
GAATTTTTTTCCTTTAGTGTYGGGCAACCATTCCAAGGGGC	non-PUS3
TAAATCTGTCTTGTAGGTTTYGGAACTGAAAGAACACAAAC	non-PUS3
CCTGTCATTGTCAGAGGAATYGGCAGGTATTCCCGATCTGC	non-PUS3
CCATTCAGTTTGAATCTGCTYGGGCACTCACTAACATTGCT	non-PUS3
TCGCCTCGCGCCGGCAGTTTYGGGCCTACACCTCCCCTCCC	non-PUS3
TTTGTGGCTTCCTTCGTTATYGGAGCCAGGCCTACACCCCA	non-PUS3
TTTGCTGGTTGTTTATTTTTYGGTACAACCAGAAAATAGTG	non-PUS3
CTCGGTCAGGTCTGGGAGAAYTGATCTTGCCTGAAAATGAA	non-PUS3
CCTGGCCTCCAGCACCTACTYGGTCCCGCGCGCTCCCTCGT	non-PUS3
GATCGAGGTGGAGATTCTATYGGTGAAACACCGACTCCTGG	non-PUS3
TTGAATAAAAGGGAATGTTTYGGCACCTGATATAATCTGCC	non-PUS3
AAAACATGGAGTTGTTCCTTYGGCCACATATATGCGAATCT	non-PUS3
TTGGGTTTTTTCTATAGGTTYGGCGGGGGGCCACAGGGAGG	non-PUS3
TTTCCCTTGCTGCGGTTGCTYGGGTGGGACAACAAGTCCAC	non-PUS3
GAAAGTTATCAGGAAGAATTYGGTCAAAAAATGCTTAGAAC	non-PUS3
CCTTAGTGTTCCTTGCATTTYGGGACAGAATGGAATCTCAG	non-PUS3
ACTTTTTCATTACGTGGGTTYTGAAATCTAGCCCCAGACAT	non-PUS3
CTTTGTGGCCTGTGGGGGGTYGGACAACATCTGCTCCATCT	non-PUS3
AACATCTCCCCCTTCTCCTTYGGGCTGGTCATCCAGCAGGT	non-PUS3
CCCAAGCATCAAATTCTGCTYGGACAATGGAGCCAAGTCGG	non-PUS3
CGCCAGGCCTTTGCCCCCTTYGGCCCCATCAAGAGCATCGA	non-PUS3
GCTACGGGACTACCTGAGCTYTGGGGGTCGGAGGCCCCCTC	non-PUS3
TCTGGAATTGTGGAAGTGGTYGGAAGAGTAACCGCCAAGGC	non-PUS3
TGATCATACTGGGCAGGCGTYGGCGTGGGGTCGGACACCCC	non-PUS3
CATCATTCGTCAGCGACAATYGGACAGAAAGGCTCTGGAAA	non-PUS3
CTCTTCCCACCCTTCAAGCTYGGAATCCACGAAGACTCCAC	non-PUS3
ATCTATGCCTATGATAACTTYGGCGTGCTGGGCCTGGACCT	non-PUS3
TGTTTTTCGAAGGATAATTTYGGAGGCAGAAAAAATGGACG	non-PUS3
GAGTTTTTCATCTTAGAGATYGGTGAACAAGTGTGAGGGTG	non-PUS3
TTTACATCCAAACATCACTTYGGCTTCGAAGCCGCCGCCTG	non-PUS3
AACTTTAGAAACTGTTCCTTYGGAGAGGAAAAAGGTACTCT	non-PUS3
TGTGGTCTCTTTGGGGCCGAYTGGGAGAAAGAGAAATCAAT	non-PUS3
CTGGAAGGGGCTGGGCTCTAYTGGGGGCCACTGAGCGCCGC	non-PUS3
GATGGCAAGCATGTGGTGTTYGGCAAAGTTCTAGAGGGCAT	non-PUS3
GAAAGGGGTTCAGGAGGTTTYGGTTCCACTGGAAAGAATTA	non-PUS3
TCTCTTGCTTCAACAGTGTTYGGACGGAACAGATCCGGGGA	non-PUS3
CAAAGGATTCCAGCAGATTTYGGCAGGTGAGATTTTGAGTA	non-PUS3
AATTGATAAAGAAGGTGTGAYTGAACCAGACACTGATGCTC	non-PUS3
GTCTATGTCAATGATGCTTTYGGCACTGCTCACAGAGCCCA	non-PUS3
AGCGGGTACAGAATGGATTTYGGAAGAGGGAGTCACCACTG	non-PUS3
TGGGGAAAAGAGACCATCCTYGGTCCCTAAGCCTCCAGAAA	non-PUS3
ATTATTTTGAAACTTTGCTTYGGGTTTGTGGCACCCTGGCC	non-PUS3
CCATTCCATGTCTAATATATYGGGATGGCATCACCTTCTGT	non-PUS3
TGGTTTTTATTCTGCTTATTYGGTTGCTGAGAAAGTAACTG	non-PUS3
CCCTGGTTTAACTAGCCTGTYTGGTAAGTAACTGAATATTT	non-PUS3
CAGACAGCCCCGAAGATTTTYGGAGGTGAAATCAAGACTCA	non-PUS3
TCAGATACTTACATAGTTTTYGGGGAAGCCAAGGTGAGTAA	non-PUS3
TCTGCTTTTTTTTTTTCAGTYGGACTAAATGCTCTTCCTTC	non-PUS3
CCAGGAGAAAGTGGAATCTTYGGAACAGGAAGCAGCCAACG	non-PUS3
GTAGCGTGGATAGCTGTGATYGGTGAGTCAACCGTCTGTGG	non-PUS3
CGCTGCAAGTCCAAAAAGTTYGGAGGTCCTGGTGCCCGTGC	non-PUS3
TTCCTTGAAGAAATACAGCTYGGTGAAGAGTTACTAGCTCA	non-PUS3
GGGGTCTAGGAGGGGCATTTYGGAGACTGCCTGACACCACC	non-PUS3
GTGGTTCTAGCCAGGCAGCTYGGAGAAGGCGCAATACTCTC	non-PUS3
AGGCGGACGACTAGAGTCGTYGGGCCCGGCGCGACCCGCAG	non-PUS3
GAAGCTGTTTCCTAATAGTTYGGACCAGACAGACATGCACG	non-PUS3
TGCAGAATATGCTAAACTTTYGGCCAAGAGAATGAAGGTTA	non-PUS3
TGTGTGTGGTTCCTTCTACTYGGGGATCATGCAGAGAGCTT	non-PUS3
ACATGAAGTTTGGTGCATCTYGGTTTATGCTGGCTCAACTG	non-PUS3
ATAACCACAAAAATAATGAAYTGATGAGAAATACAATGAAG	non-PUS3
GAGGTGATTTTCATATTGAAYTGCAAATTCGAAGAAGCAGC	non-PUS3
CTCACGATCCTTCTGACCTTYTGGGTTTTAAGCAGGAGGTG	non-PUS3
GTTGATTAAGTCCCTGCCCTYTGTACACACCGCCCGTCGCT	non-PUS3
CACAGCCAAGGGAACGGGCTYGGCGGAATCAGCGGGGAAAG	non-PUS3
GGTGCATGGCCGTTCTTAGTYGGTGGAGCGATTTGTCTGGT	non-PUS3
GGAACCGCAGGTTCAGACATYTGGTGTATGTGCTTGGCTGA	non-PUS3
CAGCAGCACATATACTAAAAYTGGAACGATACAGAGAAGAT	non-PUS3
GTGGCCTAATGGATAAGGCAYTGGCCTCCTAAGCCAGGGAT	non-PUS3
AAAATGGCTGAGTGAAGCATYGGACTGTAAATCTAAAGACA	non-PUS3
TAGCTCAGGTGGTAGAGCATYTGACTGCAGATCAAGAGGTC	non-PUS3
AAAGGATAACAGCTATCCATYGGTCTTAGGCCCCAAAAATT	non-PUS3
AACCACTTGGAGAAGTTGTTYGTGACAAACGATGCAGCAAC	non-PUS3
AAAGACTATTTTACTAAATTYGGAGAGGTCGTTGACTGTAC	non-PUS3
CTTATACACAATTCATTCTTYGCAGCTAATTAAGCCGAAGA	non-PUS3
GGAAGGGGCAGTGATGCCTTYGAGGGGAAGGAGGAGCCCCT	non-PUS3
AAAGCTCAGCTGGTGGTGATYGCACACGACGTGGATCCCAT	non-PUS3
ATGCAGACGGACGAAGAGATYGGGAAGGTGGCGGCGGCGGT	non-PUS3
AGCGAAAAGCTGTTGTAGTTYGCCCAAAAGATGAAGACTAT	non-PUS3
GATGATGGATTCTGTGTGTTYGAGAGCAACGCCATTGCCTA	non-PUS3
ACCCCATGGCTTCCATCTTTYGCATCACCACCACTCCTGAA	non-PUS3
CTAGATCTTGTGGAGAATTTYGATGAGGCTTCCAAGAATGA	non-PUS3
ATCTCCTCAGATGGCCAGTTYGCCCTCTCAGGCTCCTGGGA	non-PUS3
TTGGCTCATGAAATAGGTTTYGGAAGTAAAGTTACAACACA	non-PUS3
GACAAAGTATTTTGTCCATTYGAGATTCTGCACTCCATGAA	non-PUS3
TGCATGCAATTGTGTAGGATYGACAAGGAACTCAGATAAAA	non-PUS3
CAGAGCAGGCTGGAGGGATTYGCCACACAGCCCCACCCTTG	non-PUS3
TTTGATACTCAACTCATTATYGAAAAGGCCGAACATGGAGA	non-PUS3
TTGCTGCAGCTTAAAATGATYGGAATCAAGAAGGTACAGGG	non-PUS3
GCCGGCAAGGCGGCTCTGTTYGTGAGCAACAACAGCCGGCG	non-PUS3
ATTTTCCATTCTAAAAGTTTYGGAGAGGGAAATCCAGGCTA	non-PUS3
CGCGTCTCCTTTGAGCTGTTYGCAGACAAGGTCCCAAAGAC	non-PUS3
GCTGTCTATTTGTTCCCTTTYGACAGACTGCAACCCTGGTA	non-PUS3
AGGAGGTTTTTATTTCCCTTYGTGCGGGTGGCTGGGGCCGG	non-PUS3
CTGTGCAGCCGAGCTCGTTTYGAGAGGTAAGACCCATTCTT	non-PUS3
ACATCAACGATGCTTGGGTTYGCACCAATGACATGTTCAGG	non-PUS3
CAAGAAGTATGATGCGTTTTYGGCCTCAGAGTCTCTGATCA	non-PUS3
CACAGTCTGCTCCTTTTTTTYGTCCGCCACACGTAACTGAG	non-PUS3
CCCCCACTGTGGTGGTATATYGTGACCAGACCCCGGGAGCG	non-PUS3
CCTAATTCTTCTGCTCTGTTYGGGAAGACGTGGAGGAAAAG	non-PUS3
CCAGACCATTAATTTGATTTYGGATGAAAGCCATGAACGAG	non-PUS3
TGGTTGGGCCTGGTTGACTTYGCCAGTCAGCTCCTACAGTG	non-PUS3
TTCCACACATTTAAAACATTYGAAGGACCTAAATTCGTAGC	non-PUS3
CACGGGAAAGTAGAGATAATYGCCAATGATCAGGGAAACCG	non-PUS3
TTGGATGAGGATACAGGATTYGGTCTCTTTGACTAATCACC	non-PUS3
TCATTCATATTTGCCAGTATYGCTCACTTCAAAGAAACTCC	non-PUS3
TTTGCTAGGTCTGTTCTTTTYGAAGCTCCCCATGTCTAACT	non-PUS3
CTTCTTTTTGCAGGCAAGATYGTGGCAGAGCGTCCTGGCAC	non-PUS3
CGAGGGAGAGAGTTTTCCTTYGGTAAGTAAGCGTTTTATTT	non-PUS3
GATTTTTCTTCCTTTTTCTTYGCACACCAGCTCTACTCTTT	non-PUS3
CCACCGTTCCCAGGTGGGTTYGCAAGCACATCAAGAAGCCC	non-PUS3
TTGAGATGTATGAAGGCTTTYGGTCTCCCTGGGAGTGGGTG	non-PUS3
ACATGGCCCGCAGTGGCTTTYGCCCCAGAAAGGGGAAAGGA	non-PUS3
GGATTCCATGTTCATGAGTTYGGAGATAATACAGCAGGTGG	non-PUS3
CCTCTCCTTGCCAGGTACTTYGACCCAGCCAACGGCAAGTT	non-PUS3
GAGTGCAGCTATTGGAGCTTYGCAGGAGGCAAGTGAGGCCT	non-PUS3
GAGGAGAAAGCCAAGGAGATYGCGAAGATGGCAGAGATGCT	non-PUS3
GTGTAAATGTTGAGCCTTTTYGGCCTGGCTTGTTTGCAAAG	non-PUS3
GTCGCCAATATGCAGCTCTTYGTCCGCGCCCAGGAGCTACA	non-PUS3
TTGTTTTGTATAGTATTTATYGATTCAGGAAACAAACACAA	non-PUS3
AAATTTACATCATTTCTTTTYGGGAGAGACTTGTTTTGGAT	non-PUS3
AGCAGCTGGACTGGGGCCTTYGGCACAGCAGCCGGTGTCTC	non-PUS3
GCCCTGCTCACGTACATGATYGCGCACATCACGGGCCTGAA	non-PUS3
CTTGGGGGTGTTCCTCTATTYGCCTGCCACCTCTCTTGTCT	non-PUS3
GAAAATAAGGAAATTTCTTTYGACACAATGCAGCAAGAACT	non-PUS3
AGACCAGACAACTTTGTATTYGGTGAGTTATACAGATGATA	non-PUS3
ACTCTTAAGGAAAAACTCATYGCACCAGTTGCGGAAGAAGA	non-PUS3
TTGCAGGATTGGTCTTGATTYGAGCAATGGTAAACCTCGAG	non-PUS3
AACAACCTGCTTGGCAAGTTYGAACTCACAGGCATACCTCC	non-PUS3
ATAAGTACCTATCGCAGTTTYGAAGTCGTTTCTCCCCAACT	non-PUS3
TTTGAGCGCTCGCCGTCTTTYGGCGGCAGCGGCGACGCGAG	non-PUS3
GAGAGCCTGAGGAGCCATTTYGAGCAATGGGGAACGCTCAC	non-PUS3
CCGGCTCATAAAGGTTCATTYGGACAAAGCACAGCAGAACA	non-PUS3
GATAGCCAGGGCTGTTGTTTYGGGGCCCTTCAAGGCAAAAG	non-PUS3
ACCTAAAGTTCTTATGAGATYGTCCAAAACAAAGAAACATG	non-PUS3
GATAAATTGACCGGTGTGTTYGTAAGTATCTTATATAAATA	non-PUS3
GTACAGGAAATTACTTCATTYGACAGGAGTATGTACAGAAA	non-PUS3
GACCAGCAGCGTCTGATATTYGCCGGCAAACAGCTGGAGGA	non-PUS3
TATGCCAAAGATGTAAAATTYGGTGCAGATGCCCGAGCCTT	non-PUS3
TCTCCGTGCATTTGTGCCTTYGGAACAGAGCCAAACGCCGT	non-PUS3
TCTGCATTTTTAAAACAGTTYGGCCATAATCCTAGATGCAC	non-PUS3
TGAATTCCCAGAGTTTCAATYGTAAACAAAAATGACTAAAT	non-PUS3
TGTCCAGCTGTAAGTTCATTYGAGTAGCAGACCTAACAAAT	non-PUS3
CATGCTCTGGTGGCTGGAATYGACCGCTACCCCCGCAAAGT	non-PUS3
CCCACCGTGTTCTTCGACATYGCCGTCGACGGCGAGCCCTT	non-PUS3
GCACCACCCCACTTCCATTTYGGCCAAACCAACCGCACCTC	non-PUS3
AGAAGGCAGAGGCTTCCTTTYGGACCGCCGAGGAGGTAATC	non-PUS3
AGTCCTATGGCATGAATGTTYGCCAACCAACCCCAGGAAAA	non-PUS3
CTCTTACAGAGAGGCGGATTYGGTCGTGGACGTGGTCAGCC	non-PUS3
AGACCAGACAATTTCGTGTTYGGTGAGTGCCTGGTGTGGCT	non-PUS3
GTGTTGAGGAAAGCAGACATYGACCTCACCAAGAGGGCGGG	non-PUS3
GGTGAAATTGCCTCTACCTTYGATCACCCAGAACTGGTGAA	non-PUS3
CGGATGAAGCTGACAGTGATYGACACACCAGGGTTCGGGGA	non-PUS3
CTGGACCGTCTCAAGGTGTTYGACGGCATCCCACCGCCCTA	non-PUS3
ACCTTGAACAAGTTCAATTTYGCCAGGAACAGTACCCTCAA	non-PUS3
TTCGAGTTCCAAGCAACATTYGCTCCTGCCCTGGGGCCAGC	non-PUS3
AGTAGCCAATGTTTCTCTTTYGGCCCTATACAAAGGCAAGA	non-PUS3
AAGGTCAGGGTCAGTGGATTYGGTCGTATTGGGCGCCTGGT	non-PUS3
GCAAGAAGAGATTGCCTTTTYGAAGAAACTCCACGAAGAGG	non-PUS3
GCAATGTATCCTGATTACTTYGCCAAGAGAGAACAGTGGAA	non-PUS3
TCAAGTTGGTGGAGGCCCTTYGTGCTGAACACCAAATCAAC	non-PUS3
AATTCAAAGGTTCCTGAAATYGAGGTCACCGTGGAAGGTAA	non-PUS3
CTGGGAGATGTTTTTTGTATYGCTCAGTCATACCGGGCAGA	non-PUS3
ATTTTTGTAAATGCCTTAATYGAAAACCCAACCTTTGACTC	non-PUS3
GAATACTAATCCATTCCTTTYGGCCCTGCAGCATGTCGTGC	non-PUS3
TCTTAGTTCAACTTTAAATTYGCCCACAGAACCCTCTAAAT	non-PUS3
AGCCAATGGTATGTTTTGATYGACATCAAGTGGAGACGGGA	non-PUS3
AAGCTGAAACTTAAAGGAATYGACGGAAGGGCACCACCAGG	non-PUS3
TTCCTATTTCTGCAGCGATTYGAACACTCAGCCAAGCTGCG	non-PUS3
GTGAAGAAGCTGTATGACATYGATGTGGCCAAGGTCAACAC	non-PUS3
TTGGGCATTCAGTTGGATTTYGAAAAGAACCAACTGAAGGA	non-PUS3
GCTCGCCTGGACCACAAGTTYGACCTGATGTATGCCAAGCG	non-PUS3
GCGTTCCCCCAGTGTGTGTTYGACCACTGGCAGATCCTGCC	non-PUS3
CTCAGAGATGACTCCTCTATYGAGAAACTTGCCAAGAACAA	non-PUS3
ACCCCAAGTGACGTAGATTTYGTACGGCTCACGCCGGCCGG	non-PUS3
AATCTGTTCGCTTCATTCATYGCCCCCACAATCCTAGGTCT	non-PUS3
CATGCTGTCTCTAGACTTTTYGGACGATGTGCGGCGGATGA	non-PUS3
CCTGGTATGGTGGTCACCTTYGCTCCAGTCAACGTTGCAAC	non-PUS3
AGTGCCAGGTCCTTGCCCTTYGTGGAAAGTCACAGGTCACA	non-PUS3
TCCAATGAATTTTCTGTAATYGCTGACCCAAGAGGAAACAC	non-PUS3
GAGAGGCACCCTGGATCTTTYGACGTGGTTCACGTGAAAGA	non-PUS3
CGGGCTCCCTTTGACCTTTTYGAGAACAAGAAGAAAAAGAA	non-PUS3
ATCCGTCAAGCTGGTGTCATYGACTAACCACATCCACAAAG	non-PUS3
CACTACAGTGGCAATAATATYGAACTGGGCACAGCATGCGG	non-PUS3
AATTTCTTTCCTAGGCCGTTYGAGCAAGGAAGACATTGAAC	non-PUS3
GCCGGATGGAACTTTGGGATYGGTAATAAAACTGCAGTGCC	non-PUS3
ACCTGTCTGGTGAGTTTGTTYGGACAACCTAACTCAGCTTT	non-PUS3
CAGTGCTTTGTGAGCTTTTTYGACCTGCGGGATCCGAGCCA	non-PUS3
GGCTAGATCCCCGGTGGTTTYGTGCTCAAAATAAAAAGCCT	non-PUS3
TAAGGAAATGCTGAAGCTTTYGGTAAGTGTTTGCTGGATTC	non-PUS3
TGTCTCTCTTGGATGATGTTYGCCGTCAGCATTCACCAAAT	non-PUS3
ATGGTTTGCAACTCCGATTTYGCACACCGCTCCACCGTGCC	non-PUS3
GAGAACAACGAACGGGTGTTYGACCACAAGCAGGGCACCTA	non-PUS3
GCTTTGTGTCCGCGAGTTTTYGTTCCGCTCCGCAGCGCTCT	non-PUS3
GATGCCAAGATTCGCATTTTYGACCTGGGGCGGAAAAAGGC	non-PUS3
TCTTCTTCAATATGTGAATTYGGGCTCACAGAATCAAAGCC	non-PUS3
ACCCCTGGAAAGACACCAATYGGCACACCAGCCATGAACAT	non-PUS3
TCGCTCCTCCACCAGTTTATYGCGACGTAGCATCCAGGCCT	non-PUS3
AGCTGCGGAATTTGCGGCTTYGGCAGGTGGGTGAAGAGGGG	non-PUS3
TTTTCTCAACAGGTTATTATYGCAGCAGAACTCCTAAAAAA	non-PUS3
CGCCGCCTCCATGCTGAGTTYGCTGCGGAACGAGACTGGGA	non-PUS3
GATCGCCTCTTTGACATTTTYGCCAAAATACCACTAGTGGA	non-PUS3
TTCAAGAAGTACGAGGAGATYGACAATGCCCCGGAGGAGCG	non-PUS3
TTCCTGAGGAACATGCGCTTYGCCAAGAAGCACAACAAAAA	non-PUS3
TGCTCAGCTATGTCTGCGATYGGCAGAAGATGCACCAAACT	non-PUS3
TTTTGCTGGTTATAAAGGTTYGGATTGGAGAGGGCTCACTG	non-PUS3
TACTACTAGAAGGGAGCTTTYGGTGGTAGATCCCCTGGTGT	non-PUS3
TCCCTTAGCTATATGAATTTYGGCATGTTTCAGAGAGATCA	non-PUS3
CTTTCCAACATTTTTGTTATYGGCAAGGTAAGTCTGGGTTT	non-PUS3
AAGAGAATTAATGTGCGTATYGAGCACATTAAGCACTCTAA	non-PUS3
TCTGCACCAGCTAAAAAGTTYGCAGAGACCCAACCTAAAAA	non-PUS3
GCCTTGGATCAGGAGATTATYGAAGTAGATCCTGACACTAA	non-PUS3
TGTTTCTTTCTAGTGGTCTTYGTAAGAGTGTAGAAGCATTC	non-PUS3
TTAAGGACATTCTTTTTTATYGGCGGCTCCATGGCCCTCGG	non-PUS3
GATCTGCCTTCTTCCTGTTTYGCTCTGAACATCGCCCAAAG	non-PUS3
CAGGAGAAGCCAAAAATGTTYGCCAAGGGAACTGAGATCAC	non-PUS3
TCCCATGTTCTGGCTTTCTTYGCAGCAAGCGATGGCATAGT	non-PUS3
GGGTGAGCTGGTGCCTGCTTYGACGGGCCAGGCCCTGGAGG	non-PUS3
GATGAGTTGGTGCCCCTTTTYGAGAAGGCCGGACCCATTTG	non-PUS3
GTTAATTGAGAATAGAAATTYGCCCCTGGCAAATGCACACA	non-PUS3
CGTGCCTCTGGCCAGGCTTTYGAGCTGATCTTGAAGCCACC	non-PUS3
CGGTGGCATCTACGGGGTTTYGAACAGGAAGCGGGGCCACG	non-PUS3
AGATGATTCCATTCTCCGATYGGCCAAGGCCGATGGCATCG	non-PUS3
TCGTCCATCCCATCTTCCTTYGCCCCCAGGAAAGGACGCAT	non-PUS3
AGGAGAAAAATGTGCCTGTTYGCAGGCTTCCAGCGAAAAGC	non-PUS3
ATCCCTTCAGAGATGGAGTTYGATCCTAACTCCAACCCACC	non-PUS3
CCTCCTGTGACCTCAGGGTTYGGCCCATGGGGCCCCCCCAG	non-PUS3
GCTGGCACGGCCTTTGACTTYGAGAACATGAAGCGCAAACA	non-PUS3
TGCCAGTGTCACAACAACATYGACACGACAGACCCAGAAGC	non-PUS3
CTGGTGTCCAATCTGGATTTYGGAGTCTCAGACGCCGATAT	non-PUS3
TGGAGGGCCGCTGCCTCAATYGCAGCAGCGGCTCCAAGCGA	non-PUS3
CAGTGAAGATGTTTACTCATYGCCCCCACCTCTGGTCCACA	non-PUS3
TTCCTCCTTTCTCTGTATATYGGGCTCAGAGAGTACACTGT	non-PUS3
GACAACGTCTGCATGGCCTTYGCAGGTATGAGTCGGTGGGG	non-PUS3
TACGTCCTGGAGGACTCTATYGTGGACCCACAGAATCAGAC	non-PUS3
AGTAACAACCTTATTATCATYGAAACGGACCACAATGCCTA	non-PUS3
AAATACGATGACGAGGAGTTYGAGTATCGACATGTCATGCT	non-PUS3
ATTTACAACTCCATCTACATYGGTTCCCAGGACGCTCTCAT	non-PUS3
GATTGTAGTCCCATTCAGTTYGAATCTGCTTGGGCACTCAC	non-PUS3
CAGGAACTCTTTGCTGAATTYGGAACGCTGAAGAAGGCGGC	non-PUS3
GCCTATCTCGTTGGCCTTTTYGAAGACACCAACCTGTGCAC	non-PUS3
CTCAGAAGACAAGGGCGCTTYGGCTAAGCTGGTGGAAGCTA	non-PUS3
CAAATGATCTATGAAGAGTTYGTACAAATGATGACAGCAAA	non-PUS3
CTCCCTCTCCAGATTGAGTTYGTGACGGGCACCAAAAAAGG	non-PUS3
CTTTCTGTAGTTGCAGCATTYGCAAGAAGAAGCAGAATAGA	non-PUS3
GCCAGGTGATCAGAGTTATTYGCATCCTCAGCCACCCCATC	non-PUS3
CAAGTTTGATATGTTTGTTTYGAAAGTAGCGTTGGAAGAGT	non-PUS3
TGAACACTTCTGAAAGTTTTYGGAAACTTAGAAAAGAGGGA	non-PUS3
TAGATTTCCTTCATGCCAATYGCATCGTTCACCGAGATCTG	non-PUS3
CTATGCACAAACAGTAGTTTYGTGTGTTGGCTGCTCCACTG	non-PUS3
GTGTTAACCAGCTAAAATTTYGCTCGAAGCCTTCAGTCCGT	non-PUS3
AGGCCTAAGAATTTTGGCATYGGACAGGACATCCAGCCCAA	non-PUS3
AAGAGTTGTTGGGGGTTTTTYGCATCCATAGCACTGGTTAC	non-PUS3
AATGGAAACATCCAAAAATTYGTCACAGAATTTTGAGACCC	non-PUS3
AGCCTGCTTAAAAGAGATTTYGGGGCAAAAACTCAGAATGG	non-PUS3
GAAGAAGCCTTTTCTGTGTTYGGCCAGGTAGAGAGGGCTGT	non-PUS3
GGGTAGCAGCTCCAAAGCATYGGATGCTGGATAAATTGACC	non-PUS3
GTTATATCCTCCAGGAATATYGGCCAGAGGGCTGTGCTGAA	non-PUS3
ACCATGATTGAACCTCACATYGATGTCAAGACTACCGATGG	non-PUS3
GCTCACATTGCATGCAACTTYGCTGAGCTGAAGGAAAAGAT	non-PUS3
ACTTTCTCTTACGCTGGGTTYGAAATGCAACCCAAAAAGTA	non-PUS3
GGTGTGGGCTTGTGGGTCTTYGAGACCCGAAAATTGAGAGC	non-PUS3
CAGTGGCTGAGTTCTTCCTTYGACAAGATGGCGGCAGGAGG	non-PUS3
GATCACAGGATAGGTATTTTYGCCAAGAGAGCCATCCAGAC	non-PUS3
AGAGAGCCGGATTCACTGTTYGGCTCGATATTATAAGACCA	non-PUS3
CACATCACCCTGTGGAAGTTYGAGACCAGCAAGTACTGCAT	non-PUS3
CCCCAAGTGAACTCAAGATTYGGCAGCCCCAGAGATGCCAA	non-PUS3
AAATACAAGGAAGAAACAATYGAGAAGATGCAGGAATAAAG	non-PUS3
GTATTTGAATGGGAAGCTTTYGCCCGGGGAACCAAAGCTCT	non-PUS3
TGGTTATTTCCTAAGAATATYGAAAGTGAAGCAACTATGTG	non-PUS3
TTAACCTGAAAGATATCATTYGGGTCAGAGCTCCCCTCCCT	non-PUS3
GGTTCTCCAGTTCAAATTATYGCAAAGTAAAGGATCTTTGA	non-PUS3
ATAGAAATTTCTGAATAAATYGGCAGAAGAACGCAGACAGA	non-PUS3
TTAACTACAGTGTTTTCCTTYGCACCGATCCCCACCCCAAT	non-PUS3
AGACAATGGGGGGATTCCTTYGGCACACCCACCTGGCCCCA	non-PUS3
CAGTTAAGGTGAATATGTATYGTATCACAAAACAAACCCAA	non-PUS3
TGCAAAGAGATCTGGAAATTYGCCATGAAGGAGATGGGAAC	non-PUS3
TCAGGAACGTACCCTGGCTTYGGTAGACACAGGCATTGGCA	non-PUS3
GACCCCTTGGTGGGAAGTATYGCCACTCAGTATATGACCAA	non-PUS3
CCAGATCACTGTTAATGATTYGCCTGTGGGACGCTCCGTGG	non-PUS3
ATGTATGCAAAGCATGCCTTYGTTCACTGGTACGTGGGTGA	non-PUS3
CAACATTTTTAACTCTCATTYGACAACCTACTACTAATCAC	non-PUS3
TTTAAGCTCAAGCAAATGTTYGGTAATGCAGACATGAATAC	non-PUS3
GGTATTCACATGGGTCAGTTYGTGTATTGCGGCAAGAAGGT	non-PUS3
AACATTTATTCATATTGTTTYGATTACCCTCGTGTTACTAC	non-PUS3
CCCTTCACATCCACAGATTTYGCAAACCCCCTCATCCTGCC	non-PUS3
AAAAGAATCATGGAGAAATTYGAGAAGGAGGCTGCTGAGAT	non-PUS3
TGCAAAGTGAGAAAAATCTTYGTGGGCACAAAAGGAATCCC	non-PUS3
TGGCTATGAGAGAGATTTTTYGCGATACTTACAGAGCTTAC	non-PUS3
CAGAAAGAGTTTTCTCCATTYGGTACAATCACTAGTGCAAA	non-PUS3
GTGAATATTGTGCCTGTCATYGCAAAAGCTGACACTCTCAC	non-PUS3
AAAATACATGTCTTCTACATYGACTACGGCAACGTGAGTGT	non-PUS3
TCTAGAGCTTTGGCTGAAATYGCCAAAGCCGAACTGGATGA	non-PUS3
AGAGCTAAATCTTGAGATTTYGCCCCCGGTAAGCATAAAGC	non-PUS3
CCCTTATCTGGAAAGAAGTTYGGAAACCCTGGGGAGAAATT	non-PUS3
CATGTTTGGCAGCTGAGTATYGGAGCCAGGAGCCTGCCATG	non-PUS3
TCTCAGCTGGAGATCAATTTYGGAGACCTTGGCCGCCCAGG	non-PUS3
CTTTGAACAGAAGGATCGTTYGAGTCAGTCCAAAGCCTCAA	non-PUS3
TTTTTTTTTTTTTGGATCTTYGCAAGGGCAAAACTACAAGT	non-PUS3
CTGCTGCTGGAGCACTCATTYGAGATCGGTGAGTCAGGCAA	non-PUS3
TAAGACCTCCCTGTGGTAATYGGGAGAGGTAGCCGAGTCAC	non-PUS3
TATCAGGTCTCGAATTTATTYGGAAGGGAAAATAGACTATG	non-PUS3
CGTATGTTGTCAGGTGGCTTYGGATATAGCCCCTTCCTCAG	non-PUS3
AGCTTTTCAGTCCAAATCTTYGCAAGGCTCAAAATGCCACA	non-PUS3
CATATGGAAGCAACTTTTTTYGGTGTCTCAAAGGAGTAACT	non-PUS3
GTTTCTCTTTCCTTAGTGTTYGGTGCTGGCACCAACTCGGG	non-PUS3
GGATTTGCTTTTGTCACCTTYGAAAGCCCAGCAGACGCTAA	non-PUS3
CTTGTGAGTCCTGCATCATTYGAAAATGTCCGTGCAAAGGT	non-PUS3
TTGGATGTTGCCAACAAAATYGGGATCATCTAAACTGAGTC	non-PUS3
CTGCTTCCCTCCTGCTCATTYGGGGCTGCCACCAGCTCTCC	non-PUS3
ATCTTCTACAACTCCTCCATYGAGGAAATGCCCCTCAATGT	non-PUS3
GCCACCCATGCTGGTGCCATYGCCCCATGTGAAGTCACTGT	non-PUS3
CAGTGTCTTGGGAAATTTATYGAGATTGCTGCCCGAAAGAA	non-PUS3
CTGAACCACCTGGGGGAGATYGGCACCAAGACCACACTGAG	non-PUS3
AGGATTCGTTTTCCTGGCTTYGAGCCCCTCACACCCTGGAT	non-PUS3
CCTCCCCCAGGGACCTCATTYGACAAGAGTTCGCACACCTG	non-PUS3
ATAAGCTCCAGTTTTCGTATYGCAAATAAGACTCTTACCTA	non-PUS3
ACCACCATGTATCTGGGAATYGCCGACAGGATGCAGAAGGA	non-PUS3
TAAATCTGTCTTGTAGGTTTYGGAACTGAAAGAACACAAAC	non-PUS3
GTGTCTACTGAAGATCCCTTYGACCAGGATGACTGGGGAGC	non-PUS3
TTGGTCAGAAATTACCTTTTYGACACAAGCCTACTGAATGC	non-PUS3
CCTGTCATTGTCAGAGGAATYGGCAGGTATTCCCGATCTGC	non-PUS3
GTGGATAATTCATTTGAATTYGAAAAACGTAGAAATGAACC	non-PUS3
CTTCTGAGATAAGAACCATTYGTGTAACACCAACACTTAAC	non-PUS3
TCGCCTCGCGCCGGCAGTTTYGGGCCTACACCTCCCCTCCC	non-PUS3
TTTGTGGCTTCCTTCGTTATYGGAGCCAGGCCTACACCCCA	non-PUS3
TTTGCTGGTTGTTTATTTTTYGGTACAACCAGAAAATAGTG	non-PUS3
CCAACTCTTGCTGGTTTCTTYGCTGGAGCACTTGAGCCACG	non-PUS3
TATAAAGCTGCTAGTGATATYGCAATGACAGAACTTCCACC	non-PUS3
ATGTCATCATATGCATTTTTYGTGCAAACTTGTCGGGAAGA	non-PUS3
GATCGAGGTGGAGATTCTATYGGTGAAACACCGACTCCTGG	non-PUS3
GAGGCTACGTGAAGGAAGTTYGCCTGGAGACATTTCTACTG	non-PUS3
TTGAATAAAAGGGAATGTTTYGGCACCTGATATAATCTGCC	non-PUS3
AGGCTAAAAAGTATATTTATYGCAGAGGATGTTCATAAGGC	non-PUS3
GGGCCGTGAGTGTGCGCTTTYGAGAGTCGCGGCGGAAGGAG	non-PUS3
AAAACATGGAGTTGTTCCTTYGGCCACATATATGCGAATCT	non-PUS3
TTGGGTTTTTTCTATAGGTTYGGCGGGGGGCCACAGGGAGG	non-PUS3
TTTGTGTACCCTCTTGATTTYGCCCGTACCCGTCTAGCAGC	non-PUS3
AAGACCCTTTTTCCTCTGATYGAAGCCAAGAAAAAGGATCA	non-PUS3
AACCAAAGAGCAGCGGAGTTYGAGAAGCCAGCAGCTCGGGG	non-PUS3
CCGCTCTGTGGATGAGACTTYGAGACTAGTTCAGGCCTTCC	non-PUS3
GCCCCCGCTAACCGGCTTTTYGCCCAAATGGGCCATTATCG	non-PUS3
ATATGGGATCTAAATAATTTYGCAACCCCAATGACACCAGG	non-PUS3
CCTGCGGCAGCATTGGCCTTYGCAGCGGCGGCAGCAGCACC	non-PUS3
TCTTACAGCAAACTGTAGTTYGCCTCCAAGACACCATTGTC	non-PUS3
ACAACACCCATTTTTCCTTTYGCCGACCCCAAGAGTTTTGG	non-PUS3
GAAAGTTATCAGGAAGAATTYGGTCAAAAAATGCTTAGAAC	non-PUS3
CCTTAGTGTTCCTTGCATTTYGGGACAGAATGGAATCTCAG	non-PUS3
AAATCTAAGAATATCCTCTTYGTCATCACAAAACCAGATGT	non-PUS3
CCCCAGCTGGACTTGAGTATYGACAGCCTGGATCTGAGCTG	non-PUS3
AACATCTCCCCCTTCTCCTTYGGGCTGGTCATCCAGCAGGT	non-PUS3
CGCCAGGCCTTTGCCCCCTTYGGCCCCATCAAGAGCATCGA	non-PUS3
AATGCAGCTCTGCACGAGTTYGAAACCGTCATACCTCCTTC	non-PUS3
TTGGAGGGGTTTCGTGTGTTYGACAAGGAGGGGAACGGCAA	non-PUS3
CATGGTGGTTACTCTGTGTTYGCTGGTGTTGGTGAGAGGAC	non-PUS3
TTGATGGACTCTTTGAGTTTYGTCAGCTCTCAACTGGCGGT	non-PUS3
AGGGGCACGAGGCGCGCGTTYGCACCCGAGCCCGGCCCGCG	non-PUS3
CTTGATCGACTTGCCTACATYGCCCACCCCAAGCTTGGGAA	non-PUS3
GTTTTTTAGGTCTTTGACTTYGAACTGAGCAGCCAGGATAT	non-PUS3
GCTAGCTGCCAAAAGCTCATYGAAGTGGACGATGAACGCAA	non-PUS3
TTTGAATAAATGTCACTTTTYGAGGCAAAAGAAGGAACCGT	non-PUS3
CATCATTCGTCAGCGACAATYGGACAGAAAGGCTCTGGAAA	non-PUS3
GATGAGGGGCCTCTGGCTTTYGTGAGTGCAATATTGTTTTT	non-PUS3
TGTTCCACTTATAAATTTTTYGAGGTTATCCTCATTGATCC	non-PUS3
ATCTATGCCTATGATAACTTYGGCGTGCTGGGCCTGGACCT	non-PUS3
TGTTTTTCGAAGGATAATTTYGGAGGCAGAAAAAATGGACG	non-PUS3
GAGTTTTTCATCTTAGAGATYGGTGAACAAGTGTGAGGGTG	non-PUS3
GGGATTTTGGCACAGGAAATYGTGAAGGTAAAACATCACTG	non-PUS3
TCTTTTAAAATTTTTTGTTTYGCATCCGAAACCGAAAGAAA	non-PUS3
TTTTTCGACATCAGGGTATTYGTTCCACCTTGGCCAGGCCT	non-PUS3
AAAAACTAACATTGAAATTTYGAAACAGCAGCAGAGTGAGT	non-PUS3
TTTACATCCAAACATCACTTYGGCTTCGAAGCCGCCGCCTG	non-PUS3
TACTTGGTGTTTTTTGGTTTYGTGAAACGGCCGTCCCAAAA	non-PUS3
ATACAATTGACCCAATAATTYGACCAACGGAACAAGTTACC	non-PUS3
AACTTTAGAAACTGTTCCTTYGGAGAGGAAAAAGGTACTCT	non-PUS3
TTTCAATTCCGGTTGATTTTYGTCCCTCTGCGCTTGCTCCC	non-PUS3
TAAGGATCATCAAAATTTTTYGAGACTCCTCACAGAAACTG	non-PUS3
GATGGCAAGCATGTGGTGTTYGGCAAAGTTCTAGAGGGCAT	non-PUS3
GTGAAAGAGGTTCAGAAATTYGTCAACAAAGGAGAAAAAGG	non-PUS3
TTGCAGATGTGGCTCGCTTTYGTAACCGCTACCCTAATATC	non-PUS3
AGTGGAGCCACTTTCTGTATYGTTACATGGACATATGTAAG	non-PUS3
GAAAGGGGTTCAGGAGGTTTYGGTTCCACTGGAAAGAATTA	non-PUS3
TCTCTTGCTTCAACAGTGTTYGGACGGAACAGATCCGGGGA	non-PUS3
CAAAGGATTCCAGCAGATTTYGGCAGGTGAGATTTTGAGTA	non-PUS3
AAAATATTTCCTCAGTACTTYGCAGAAAACACCAAACAAAA	non-PUS3
AGGGGAGAGAGGCTAAAGATYGTGACCCCGGCTCTCCAAGG	non-PUS3
AGACAACACTTTATCAGTTTYGACACTGACAGGAGTGGAAC	non-PUS3
GTCTATGTCAATGATGCTTTYGGCACTGCTCACAGAGCCCA	non-PUS3
AGCGGGTACAGAATGGATTTYGGAAGAGGGAGTCACCACTG	non-PUS3
GAAAAGACTCATATCAACATYGTCGTCATTGGACACGTAAA	non-PUS3
ATTATTTTGAAACTTTGCTTYGGGTTTGTGGCACCCTGGCC	non-PUS3
CCATTCCATGTCTAATATATYGGGATGGCATCACCTTCTGT	non-PUS3
TACCACATGCAGCGCTGCATYGACTCTGGCCTCTGGGTCCC	non-PUS3
TGGTTTTTATTCTGCTTATTYGGTTGCTGAGAAAGTAACTG	non-PUS3
AAGTTCAATGCTGATGAATTYGAAGACATGGTGGCTGAAAA	non-PUS3
CAGACAGCCCCGAAGATTTTYGGAGGTGAAATCAAGACTCA	non-PUS3
TCAGATACTTACATAGTTTTYGGGGAAGCCAAGGTGAGTAA	non-PUS3
GATGAGGATGAAGATGAAATYGAACCAGCAGCGATGAAAGC	non-PUS3
AACTACAAGACCGCCCCTTTYGACAGCCGCTTCCCCAACCA	non-PUS3
GCCCGAGGACTCTTGGAGTTYGAGCATCAGAGGGCCCCTAG	non-PUS3
CCAGGAGAAAGTGGAATCTTYGGAACAGGAAGCAGCCAACG	non-PUS3
CTGGAAAACCTGGAAAAAATYGAAAAGGAACAGAGCAAACA	non-PUS3
GTAGCGTGGATAGCTGTGATYGGTGAGTCAACCGTCTGTGG	non-PUS3
CGCTGCAAGTCCAAAAAGTTYGGAGGTCCTGGTGCCCGTGC	non-PUS3
GGGGTCTAGGAGGGGCATTTYGGAGACTGCCTGACACCACC	non-PUS3
TTACTTTTAACCAGTGAAATYGACCTGCCCGTGAAGAGGCG	non-PUS3
GAACTTGATGCACTGGAAATYGAGACAGTACAAAAGGAGAC	non-PUS3
AATGTAGATTCTCTGGTCATYGAGCATATCCAAGTGAACAA	non-PUS3
AACGTACCTGTCAAGCTCTTYGCCCGCTCCACAGCTGTCAC	non-PUS3
CTCCTCCTCAAGTTCCTTTTYGCACCGTCACCACCCAACAC	non-PUS3
GAAGAAGTGGAGAAGCGCTTYGAGGGTCGGCTCACCAAGAA	non-PUS3
GAAGCTGTTTCCTAATAGTTYGGACCAGACAGACATGCACG	non-PUS3
TGCAGAATATGCTAAACTTTYGGCCAAGAGAATGAAGGTTA	non-PUS3
GGAATATCCATGTACTTGTTYGCAAGCAGGACTTTGAGGCA	non-PUS3
ACGGTGCCCCCCGGGACCTTYGACACCCGGGGGTCTGAGGG	non-PUS3
AAAATGGCTGAGTGAAGCATYGGACTGTAAATCTAAAGACA	non-PUS3
CGGACCAGAGCGAAAGCATTYGCCAAGAATGTTTTCATTAA	non-PUS3
GTGGAGCCTGCGGCTTAATTYGACTCAACACGGGAAACCTC	non-PUS3
AAAGGATAACAGCTATCCATYGGTCTTAGGCCCCAAAAATT	non-PUS3
